,Coach,Team,numSznsWTeam,numTotSzns,curr_games,curr_wins,curr_losses,franch_games,franch_wins,franch_losses,tot_games,tot_wins,tot_losses,win_percent,curr_pl_games,curr_pl_wins,curr_pl_losses,franch_pl_games,franch_pl_wins,franch_pl_losses,tot_pl_games,tot_pl_wins,tot_pl_losses,Season
0,Red Auerbach,BOS,13,17,80,58,22,952,620,332,1177,763,414,0.648,13.0,8.0,5.0,109.0,63.0,46.0,129.0,72.0,57.0,1962
1,Jack McMahon,CHZ,1,1,38,12,26,38,12,26,38,12,26,0.316,,,,,,,,,,1962
2,Slick Leonard,CHZ,1,1,42,13,29,42,13,29,42,13,29,0.31,,,,,,,,,,1962
3,Charles Wolf,CIN,3,3,80,42,38,239,118,121,239,118,121,0.494,12.0,6.0,6.0,16.0,7.0,9.0,16.0,7.0,9.0,1962
4,Dick McGuire,DET,4,4,80,34,46,280,122,158,280,122,158,0.436,4.0,1.0,3.0,21.0,8.0,13.0,21.0,8.0,13.0,1962
5,Fred Schaus,LAL,3,3,80,53,27,239,143,96,239,143,96,0.598,13.0,6.0,7.0,38.0,19.0,19.0,38.0,19.0,19.0,1962
6,Eddie Donovan,NYK,2,2,80,21,59,160,50,110,160,50,110,0.313,,,,,,,,,,1962
7,Bob Feerick,SFW,1,2,80,31,49,80,31,49,148,63,85,0.426,,,,,,,2.0,0.0,2.0,1962
8,Harry Gallatin,STL,1,1,80,48,32,80,48,32,80,48,32,0.6,11.0,6.0,5.0,11.0,6.0,5.0,11.0,6.0,5.0,1962
9,Alex Hannum,SYR,3,5,80,48,32,239,127,112,342,183,159,0.535,5.0,2.0,3.0,18.0,8.0,10.0,39.0,22.0,17.0,1962
10,Richie Guerin,ATL,7,7,82,36,46,536,291,245,536,291,245,0.5429999999999999,5.0,1.0,4.0,54.0,24.0,30.0,54.0,24.0,30.0,1970
11,Gene Shue,BAL,5,5,82,42,40,384,201,183,384,201,183,0.523,18.0,8.0,10.0,29.0,11.0,18.0,29.0,11.0,18.0,1970
12,Tom Heinsohn,BOS,2,2,82,44,38,164,78,86,164,78,86,0.47600000000000003,,,,,,,,,,1970
13,Dolph Schayes,BUF,1,4,82,22,60,82,22,60,322,151,171,0.469,,,,,,,21.0,9.0,12.0,1970
14,Dick Motta,CHI,3,3,82,51,31,246,123,123,246,123,123,0.5,7.0,3.0,4.0,12.0,4.0,8.0,12.0,4.0,8.0,1970
15,Bob Cousy,CIN,2,2,82,33,49,164,69,95,164,69,95,0.42100000000000004,,,,,,,,,,1970
16,Bill Fitch,CLE,1,1,82,15,67,82,15,67,82,15,67,0.183,,,,,,,,,,1970
17,Butch van Breda Kolff,DET,2,4,82,45,37,164,76,88,328,183,145,0.5579999999999999,,,,,,,33.0,21.0,12.0,1970
18,Joe Mullaney,LAL,2,2,82,48,34,164,94,70,164,94,70,0.573,12.0,5.0,7.0,30.0,16.0,14.0,30.0,16.0,14.0,1970
19,Larry Costello,MIL,3,3,82,66,16,246,149,97,246,149,97,0.606,14.0,12.0,2.0,24.0,17.0,7.0,24.0,17.0,7.0,1970
20,Red Holzman,NYK,4,8,82,52,30,290,194,96,493,277,216,0.562,12.0,7.0,5.0,47.0,27.0,20.0,55.0,31.0,24.0,1970
21,Jack Ramsay,PHI,3,3,82,47,35,246,144,102,246,144,102,0.585,7.0,3.0,4.0,17.0,5.0,12.0,17.0,5.0,12.0,1970
22,Cotton Fitzsimmons,PHO,1,1,82,48,34,82,48,34,82,48,34,0.585,,,,,,,,,,1970
23,Rolland Todd,POR,1,1,82,29,53,82,29,53,82,29,53,0.354,,,,,,,,,,1970
24,Alex Hannum,SDR,2,13,82,40,42,138,58,80,961,531,430,0.5529999999999999,,,,,,,95.0,57.0,38.0,1970
25,Lenny Wilkens,SEA,2,2,82,38,44,164,74,90,164,74,90,0.451,,,,,,,,,,1970
26,Al Attles,SFW,2,2,82,41,41,112,49,63,112,49,63,0.43799999999999994,5.0,1.0,4.0,5.0,1.0,4.0,5.0,1.0,4.0,1970
27,Lon Kruger,ATL,3,3,27,11,16,191,69,122,191,69,122,0.361,,,,,,,,,,2002
28,Terry Stotts,ATL,1,1,55,24,31,55,24,31,55,24,31,0.436,,,,,,,,,,2002
29,Jim O'Brien,BOS,3,3,82,44,38,212,117,95,212,117,95,0.552,10.0,4.0,6.0,26.0,13.0,13.0,26.0,13.0,13.0,2002
30,Bill Cartwright,CHI,2,2,82,30,52,137,47,90,137,47,90,0.34299999999999997,,,,,,,,,,2002
31,John Lucas,CLE,2,6,42,8,34,124,37,87,431,173,258,0.401,,,,,,,14.0,6.0,8.0,2002
32,Keith Smart,CLE,1,1,40,9,31,40,9,31,40,9,31,0.225,,,,,,,,,,2002
33,Don Nelson,DAL,6,25,82,60,22,444,245,199,1924,1096,828,0.57,20.0,10.0,10.0,38.0,18.0,20.0,150.0,69.0,81.0,2002
34,Jeff Bzdelik,DEN,1,1,82,17,65,82,17,65,82,17,65,0.207,,,,,,,,,,2002
35,Rick Carlisle,DET,2,2,82,50,32,164,100,64,164,100,64,0.61,17.0,8.0,9.0,27.0,12.0,15.0,27.0,12.0,15.0,2002
36,Eric Musselman,GSW,1,1,82,38,44,82,38,44,82,38,44,0.46299999999999997,,,,,,,,,,2002
37,Rudy Tomjanovich,HOU,12,12,82,43,39,900,503,397,900,503,397,0.5589999999999999,,,,90.0,51.0,39.0,90.0,51.0,39.0,2002
38,Isiah Thomas,IND,3,3,82,48,34,246,131,115,246,131,115,0.5329999999999999,6.0,2.0,4.0,15.0,5.0,10.0,15.0,5.0,10.0,2002
39,Alvin Gentry,LAC,3,7,58,19,39,222,89,133,403,177,226,0.439,,,,,,,5.0,2.0,3.0,2002
40,Dennis Johnson,LAC,1,1,24,8,16,24,8,16,24,8,16,0.33299999999999996,,,,,,,,,,2002
41,Phil Jackson,LAL,4,13,82,50,32,328,231,97,1066,776,290,0.728,12.0,6.0,6.0,70.0,51.0,19.0,222.0,162.0,60.0,2002
42,Sidney Lowe,MEM,3,5,8,0,8,172,46,126,307,79,228,0.257,,,,,,,,,,2002
43,Hubie Brown,MEM,1,13,74,28,46,74,28,46,993,473,520,0.47600000000000003,,,,,,,59.0,31.0,28.0,2002
44,Pat Riley,MIA,8,21,82,25,57,624,354,270,1679,1110,569,0.6609999999999999,,,,43.0,18.0,25.0,255.0,155.0,100.0,2002
45,George Karl,MIL,5,16,82,42,40,378,205,173,1207,708,499,0.5870000000000001,6.0,2.0,4.0,32.0,14.0,18.0,126.0,59.0,67.0,2002
46,Flip Saunders,MIN,8,8,82,51,31,604,328,276,604,328,276,0.5429999999999999,6.0,2.0,4.0,29.0,7.0,22.0,29.0,7.0,22.0,2002
47,Byron Scott,NJN,3,3,82,49,33,246,127,119,246,127,119,0.516,20.0,14.0,6.0,40.0,25.0,15.0,40.0,25.0,15.0,2002
48,Paul Silas,NOH,1,8,82,47,35,82,47,35,609,286,323,0.47,6.0,2.0,4.0,6.0,2.0,4.0,29.0,13.0,16.0,2002
49,Don Chaney,NYK,2,11,82,37,45,145,57,88,792,322,470,0.40700000000000003,,,,,,,11.0,2.0,9.0,2002
50,Doc Rivers,ORL,4,4,82,42,40,328,170,158,328,170,158,0.518,7.0,3.0,4.0,15.0,5.0,10.0,15.0,5.0,10.0,2002
51,Larry Brown,PHI,6,24,82,48,34,460,255,205,1900,1108,792,0.583,12.0,6.0,6.0,58.0,28.0,30.0,183.0,89.0,94.0,2002
52,Frank Johnson,PHO,2,2,82,44,38,113,55,58,113,55,58,0.48700000000000004,6.0,2.0,4.0,6.0,2.0,4.0,6.0,2.0,4.0,2002
53,Maurice Cheeks,POR,2,2,82,50,32,164,99,65,164,99,65,0.604,7.0,3.0,4.0,10.0,3.0,7.0,10.0,3.0,7.0,2002
54,Rick Adelman,SAC,5,13,82,59,23,378,246,132,987,603,384,0.611,12.0,7.0,5.0,46.0,24.0,22.0,115.0,60.0,55.0,2002
55,Gregg Popovich,SAS,7,7,82,60,22,524,339,185,524,339,185,0.647,24.0,16.0,8.0,77.0,47.0,30.0,77.0,47.0,30.0,2002
56,Nate McMillan,SEA,3,3,82,40,42,231,123,108,231,123,108,0.532,,,,5.0,2.0,3.0,5.0,2.0,3.0,2002
57,Lenny Wilkens,TOR,3,30,82,24,58,246,113,133,2406,1292,1114,0.537,,,,17.0,8.0,9.0,174.0,80.0,94.0,2002
58,Jerry Sloan,UTA,15,18,82,47,35,1181,781,400,1396,875,521,0.627,5.0,1.0,4.0,152.0,76.0,76.0,158.0,78.0,80.0,2002
59,Doug Collins,WAS,2,8,82,37,45,164,74,90,619,332,287,0.536,,,,,,,38.0,15.0,23.0,2002
60,Lenny Wilkens,ATL,1,21,82,57,25,82,57,25,1700,926,774,0.545,11.0,5.0,6.0,11.0,5.0,6.0,121.0,60.0,61.0,1993
61,Chris Ford,BOS,4,4,82,32,50,328,187,141,328,187,141,0.57,,,,25.0,12.0,13.0,25.0,12.0,13.0,1993
62,Allan Bristow,CHH,3,3,82,41,41,246,116,130,246,116,130,0.47200000000000003,,,,9.0,4.0,5.0,9.0,4.0,5.0,1993
63,Phil Jackson,CHI,5,5,82,55,27,410,295,115,410,295,115,0.72,10.0,6.0,4.0,84.0,61.0,23.0,84.0,61.0,23.0,1993
64,Mike Fratello,CLE,1,9,82,47,35,82,47,35,659,371,288,0.563,3.0,0.0,3.0,3.0,0.0,3.0,43.0,18.0,25.0,1993
65,Quinn Buckner,DAL,1,1,82,13,69,82,13,69,82,13,69,0.159,,,,,,,,,,1993
66,Dan Issel,DEN,2,2,82,42,40,164,78,86,164,78,86,0.47600000000000003,12.0,6.0,6.0,12.0,6.0,6.0,12.0,6.0,6.0,1993
67,Don Chaney,DET,1,8,82,20,62,82,20,62,565,237,328,0.419,,,,,,,11.0,2.0,9.0,1993
68,Don Nelson,GSW,6,17,82,50,32,492,263,229,1376,803,573,0.584,3.0,0.0,3.0,24.0,9.0,15.0,112.0,51.0,61.0,1993
69,Rudy Tomjanovich,HOU,3,3,82,58,24,194,129,65,194,129,65,0.665,23.0,15.0,8.0,35.0,21.0,14.0,35.0,21.0,14.0,1993
70,Larry Brown,IND,1,15,82,47,35,82,47,35,1194,710,484,0.595,16.0,10.0,6.0,16.0,10.0,6.0,103.0,49.0,54.0,1993
71,Bob Weiss,LAC,1,6,82,27,55,82,27,55,492,210,282,0.42700000000000005,,,,,,,11.0,2.0,9.0,1993
72,Randy Pfund,LAL,2,2,64,27,37,146,66,80,146,66,80,0.452,,,,5.0,2.0,3.0,5.0,2.0,3.0,1993
73,Bill Bertka,LAL,1,1,2,1,1,2,1,1,2,1,1,0.5,,,,,,,,,,1993
74,Magic Johnson,LAL,1,1,16,5,11,16,5,11,16,5,11,0.313,,,,,,,,,,1993
75,Kevin Loughery,MIA,3,19,82,42,40,246,116,130,1342,625,717,0.466,5.0,2.0,3.0,8.0,2.0,6.0,59.0,27.0,32.0,1993
76,Mike Dunleavy,MIL,2,4,82,20,62,164,48,116,328,149,179,0.45399999999999996,,,,,,,23.0,13.0,10.0,1993
77,Sidney Lowe,MIN,2,2,82,20,62,135,33,102,135,33,102,0.244,,,,,,,,,,1993
78,Chuck Daly,NJN,2,12,82,45,37,164,88,76,943,564,379,0.598,4.0,1.0,3.0,9.0,3.0,6.0,122.0,74.0,48.0,1993
79,Pat Riley,NYK,3,12,82,57,25,246,168,78,973,701,272,0.72,25.0,14.0,11.0,52.0,29.0,23.0,201.0,131.0,70.0,1993
80,Brian Hill,ORL,1,1,82,50,32,82,50,32,82,50,32,0.61,3.0,0.0,3.0,3.0,0.0,3.0,3.0,0.0,3.0,1993
81,Fred Carter,PHI,2,2,82,25,57,108,32,76,108,32,76,0.29600000000000004,,,,,,,,,,1993
82,Paul Westphal,PHO,2,2,82,56,26,164,118,46,164,118,46,0.72,10.0,6.0,4.0,34.0,19.0,15.0,34.0,19.0,15.0,1993
83,Rick Adelman,POR,6,6,82,47,35,445,291,154,445,291,154,0.654,4.0,1.0,3.0,69.0,36.0,33.0,69.0,36.0,33.0,1993
84,Garry St. Jean,SAC,2,2,82,28,54,164,53,111,164,53,111,0.32299999999999995,,,,,,,,,,1993
85,John Lucas,SAS,2,2,82,55,27,143,94,49,143,94,49,0.657,4.0,1.0,3.0,14.0,6.0,8.0,14.0,6.0,8.0,1993
86,George Karl,SEA,3,7,82,63,19,206,145,61,501,264,237,0.527,5.0,2.0,3.0,33.0,16.0,17.0,47.0,21.0,26.0,1993
87,Jerry Sloan,UTA,6,9,82,53,29,475,304,171,690,398,292,0.5770000000000001,16.0,8.0,8.0,54.0,25.0,29.0,60.0,27.0,33.0,1993
88,Wes Unseld,WSB,7,7,82,24,58,547,202,345,547,202,345,0.369,,,,5.0,2.0,3.0,5.0,2.0,3.0,1993
89,Lenny Wilkens,ATL,6,26,50,31,19,460,282,178,2078,1151,927,0.5539999999999999,9.0,3.0,6.0,47.0,17.0,30.0,157.0,72.0,85.0,1998
90,Rick Pitino,BOS,2,4,50,19,31,132,55,77,296,145,151,0.49,,,,,,,13.0,6.0,7.0,1998
91,Dave Cowens,CHH,3,4,15,4,11,179,109,70,247,136,111,0.551,,,,12.0,4.0,8.0,12.0,4.0,8.0,1998
92,Paul Silas,CHH,1,4,35,22,13,35,22,13,281,100,181,0.35600000000000004,,,,,,,,,,1998
93,Tim Floyd,CHI,1,1,50,13,37,50,13,37,50,13,37,0.26,,,,,,,,,,1998
94,Mike Fratello,CLE,6,14,50,22,28,460,248,212,1037,572,465,0.552,,,,14.0,2.0,12.0,54.0,20.0,34.0,1998
95,Don Nelson,DAL,2,21,50,19,31,116,35,81,1596,886,710,0.555,,,,,,,112.0,51.0,61.0,1998
96,Mike D'Antoni,DEN,1,1,50,14,36,50,14,36,50,14,36,0.28,,,,,,,,,,1998
97,Alvin Gentry,DET,2,3,50,29,21,87,45,42,123,60,63,0.488,5.0,2.0,3.0,5.0,2.0,3.0,5.0,2.0,3.0,1998
98,P.J. Carlesimo,GSW,2,5,50,21,29,132,40,92,378,177,201,0.46799999999999997,,,,,,,12.0,3.0,9.0,1998
99,Rudy Tomjanovich,HOU,8,8,50,31,19,572,353,219,572,353,219,0.617,4.0,1.0,3.0,90.0,51.0,39.0,90.0,51.0,39.0,1998
100,Larry Bird,IND,2,2,50,33,17,132,91,41,132,91,41,0.6890000000000001,13.0,9.0,4.0,29.0,19.0,10.0,29.0,19.0,10.0,1998
101,Chris Ford,LAC,1,8,50,9,41,50,9,41,624,300,324,0.48100000000000004,,,,,,,29.0,13.0,16.0,1998
102,Del Harris,LAL,5,14,12,6,6,340,224,116,1013,556,457,0.5489999999999999,,,,36.0,17.0,19.0,88.0,38.0,50.0,1998
103,Bill Bertka,LAL,2,2,1,1,0,3,2,1,3,2,1,0.667,,,,,,,,,,1998
104,Kurt Rambis,LAL,1,1,37,24,13,37,24,13,37,24,13,0.649,8.0,3.0,5.0,8.0,3.0,5.0,8.0,3.0,5.0,1998
105,Pat Riley,MIA,4,17,50,33,17,296,191,105,1351,947,404,0.701,5.0,2.0,3.0,30.0,12.0,18.0,242.0,149.0,93.0,1998
106,George Karl,MIL,1,12,50,28,22,50,28,22,879,531,348,0.604,3.0,0.0,3.0,3.0,0.0,3.0,97.0,45.0,52.0,1998
107,Flip Saunders,MIN,4,4,50,25,25,276,130,146,276,130,146,0.47100000000000003,4.0,1.0,3.0,12.0,3.0,9.0,12.0,3.0,9.0,1998
108,John Calipari,NJN,3,3,20,3,17,184,72,112,184,72,112,0.391,,,,3.0,0.0,3.0,3.0,0.0,3.0,1998
109,Don Casey,NJN,1,3,30,13,17,30,13,17,156,54,102,0.34600000000000003,,,,,,,,,,1998
110,Jeff Van Gundy,NYK,4,4,50,27,23,237,140,97,237,140,97,0.591,20.0,12.0,8.0,48.0,26.0,22.0,48.0,26.0,22.0,1998
111,Chuck Daly,ORL,2,14,50,33,17,132,74,58,1075,638,437,0.593,4.0,1.0,3.0,4.0,1.0,3.0,126.0,75.0,51.0,1998
112,Larry Brown,PHI,2,20,50,28,22,132,59,73,1572,912,660,0.58,8.0,3.0,5.0,8.0,3.0,5.0,133.0,64.0,69.0,1998
113,Danny Ainge,PHO,3,3,50,27,23,206,123,83,206,123,83,0.597,3.0,0.0,3.0,12.0,3.0,9.0,12.0,3.0,9.0,1998
114,Mike Dunleavy,POR,2,8,50,35,15,132,81,51,624,289,335,0.46299999999999997,13.0,7.0,6.0,17.0,8.0,9.0,40.0,21.0,19.0,1998
115,Rick Adelman,SAC,1,9,50,27,23,50,27,23,659,384,275,0.583,5.0,2.0,3.0,5.0,2.0,3.0,74.0,38.0,36.0,1998
116,Gregg Popovich,SAS,3,3,50,37,13,196,110,86,196,110,86,0.561,17.0,15.0,2.0,26.0,19.0,7.0,26.0,19.0,7.0,1998
117,Paul Westphal,SEA,1,5,50,25,25,50,25,25,329,216,113,0.657,,,,,,,44.0,25.0,19.0,1998
118,Butch Carter,TOR,2,2,50,23,27,83,28,55,83,28,55,0.337,,,,,,,,,,1998
119,Jerry Sloan,UTA,11,14,50,37,13,853,582,271,1068,676,392,0.633,11.0,5.0,6.0,128.0,68.0,60.0,134.0,70.0,64.0,1998
120,Brian Hill,VAN,2,6,50,8,42,132,27,105,427,218,209,0.511,,,,,,,36.0,18.0,18.0,1998
121,Bernie Bickerstaff,WAS,3,10,32,13,19,149,77,72,686,338,348,0.493,,,,3.0,0.0,3.0,33.0,12.0,21.0,1998
122,Jim Brovelli,WAS,1,1,18,5,13,18,5,13,18,5,13,0.278,,,,,,,,,,1998
123,Lloyd Pierce,ATL,1,1,82,29,53,82,29,53,82,29,53,0.354,,,,,,,,,,2018
124,Brad Stevens,BOS,6,6,82,49,33,492,270,222,492,270,222,0.5489999999999999,9.0,5.0,4.0,56.0,27.0,29.0,56.0,27.0,29.0,2018
125,Kenny Atkinson,BRK,3,3,82,42,40,246,90,156,246,90,156,0.366,5.0,1.0,4.0,5.0,1.0,4.0,5.0,1.0,4.0,2018
126,Fred Hoiberg,CHI,4,4,24,5,19,270,115,155,270,115,155,0.426,,,,6.0,2.0,4.0,6.0,2.0,4.0,2018
127,Jim Boylen,CHI,1,1,58,17,41,58,17,41,58,17,41,0.293,,,,,,,,,,2018
128,James Borrego,CHO,1,2,82,39,43,82,39,43,112,49,63,0.43799999999999994,,,,,,,,,,2018
129,Tyronn Lue,CLE,4,4,6,0,6,211,128,83,211,128,83,0.607,,,,61.0,41.0,20.0,61.0,41.0,20.0,2018
130,Larry Drew,CLE,1,5,76,19,57,76,19,57,388,162,226,0.418,,,,,,,24.0,10.0,14.0,2018
131,Rick Carlisle,DAL,11,17,82,33,49,886,470,416,1378,751,627,0.545,,,,58.0,28.0,30.0,120.0,58.0,62.0,2018
132,Mike Malone,DEN,4,6,82,54,28,328,173,155,434,212,222,0.488,14.0,7.0,7.0,14.0,7.0,7.0,14.0,7.0,7.0,2018
133,Dwane Casey,DET,1,10,82,41,41,82,41,41,762,414,348,0.5429999999999999,4.0,0.0,4.0,4.0,0.0,4.0,55.0,21.0,34.0,2018
134,Steve Kerr,GSW,5,5,82,57,25,410,322,88,410,322,88,0.785,22.0,14.0,8.0,105.0,77.0,28.0,105.0,77.0,28.0,2018
135,Mike D'Antoni,HOU,3,15,82,53,29,246,173,73,1127,628,499,0.557,11.0,6.0,5.0,39.0,23.0,16.0,98.0,49.0,49.0,2018
136,Nate McMillan,IND,3,15,82,48,34,246,138,108,1176,616,560,0.524,4.0,0.0,4.0,15.0,3.0,12.0,49.0,17.0,32.0,2018
137,Doc Rivers,LAC,6,20,82,48,34,492,307,185,1552,894,658,0.5760000000000001,6.0,2.0,4.0,46.0,20.0,26.0,167.0,84.0,83.0,2018
138,Luke Walton,LAL,3,3,82,37,45,246,98,148,246,98,148,0.39799999999999996,,,,,,,,,,2018
139,J.B. Bickerstaff,MEM,2,3,82,33,49,145,48,97,216,85,131,0.39399999999999996,,,,,,,5.0,1.0,4.0,2018
140,Erik Spoelstra,MIA,11,11,82,39,43,886,523,363,886,523,363,0.59,,,,118.0,71.0,47.0,118.0,71.0,47.0,2018
141,Mike Budenholzer,MIL,1,6,82,60,22,82,60,22,492,273,219,0.555,15.0,10.0,5.0,15.0,10.0,5.0,54.0,27.0,27.0,2018
142,Tom Thibodeau,MIN,3,8,40,19,21,204,97,107,598,352,246,0.589,,,,5.0,1.0,4.0,56.0,24.0,32.0,2018
143,Ryan Saunders,MIN,1,1,42,17,25,42,17,25,42,17,25,0.405,,,,,,,,,,2018
144,Alvin Gentry,NOP,4,16,82,33,49,328,145,183,1033,480,553,0.465,,,,9.0,5.0,4.0,30.0,17.0,13.0,2018
145,David Fizdale,NYK,1,3,82,17,65,82,17,65,183,67,116,0.366,,,,,,,6.0,2.0,4.0,2018
146,Billy Donovan,OKC,4,4,82,49,33,328,199,129,328,199,129,0.607,5.0,1.0,4.0,34.0,15.0,19.0,34.0,15.0,19.0,2018
147,Steve Clifford,ORL,1,6,82,42,40,82,42,40,492,238,254,0.484,5.0,1.0,4.0,5.0,1.0,4.0,16.0,4.0,12.0,2018
148,Brett Brown,PHI,6,6,82,51,31,492,178,314,492,178,314,0.36200000000000004,12.0,7.0,5.0,22.0,12.0,10.0,22.0,12.0,10.0,2018
149,Igor Kokoskov,PHO,1,1,82,19,63,82,19,63,82,19,63,0.23199999999999998,,,,,,,,,,2018
150,Terry Stotts,POR,7,11,82,53,29,574,325,249,857,440,417,0.513,16.0,8.0,8.0,51.0,19.0,32.0,56.0,20.0,36.0,2018
151,Dave Joerger,SAC,3,6,82,39,43,246,98,148,492,245,247,0.498,,,,,,,22.0,9.0,13.0,2018
152,Gregg Popovich,SAS,23,23,82,48,34,1820,1245,575,1820,1245,575,0.684,7.0,3.0,4.0,284.0,170.0,114.0,284.0,170.0,114.0,2018
153,Nick Nurse,TOR,1,1,82,58,24,82,58,24,82,58,24,0.7070000000000001,24.0,16.0,8.0,24.0,16.0,8.0,24.0,16.0,8.0,2018
154,Quin Snyder,UTA,5,5,82,50,32,410,227,183,410,227,183,0.5539999999999999,5.0,1.0,4.0,27.0,10.0,17.0,27.0,10.0,17.0,2018
155,Scott Brooks,WAS,3,10,82,32,50,246,124,122,791,462,329,0.584,,,,19.0,9.0,10.0,92.0,48.0,44.0,2018
156,Lenny Wilkens,ATL,5,25,82,50,32,410,251,159,2028,1120,908,0.552,4.0,1.0,3.0,38.0,14.0,24.0,148.0,69.0,79.0,1997
157,Rick Pitino,BOS,1,3,82,36,46,82,36,46,246,126,120,0.512,,,,,,,13.0,6.0,7.0,1997
158,Dave Cowens,CHH,2,3,82,51,31,164,105,59,232,132,100,0.569,9.0,4.0,5.0,12.0,4.0,8.0,12.0,4.0,8.0,1997
159,Phil Jackson,CHI,9,9,82,62,20,738,545,193,738,545,193,0.738,21.0,15.0,6.0,152.0,111.0,41.0,152.0,111.0,41.0,1997
160,Mike Fratello,CLE,5,13,82,47,35,410,226,184,987,550,437,0.557,4.0,1.0,3.0,14.0,2.0,12.0,54.0,20.0,34.0,1997
161,Jim Cleamons,DAL,2,2,16,4,12,98,28,70,98,28,70,0.28600000000000003,,,,,,,,,,1997
162,Don Nelson,DAL,1,20,66,16,50,66,16,50,1546,867,679,0.561,,,,,,,112.0,51.0,61.0,1997
163,Bill Hanzlik,DEN,1,1,82,11,71,82,11,71,82,11,71,0.134,,,,,,,,,,1997
164,Doug Collins,DET,3,6,45,21,24,209,121,88,455,258,197,0.5670000000000001,,,,8.0,2.0,6.0,38.0,15.0,23.0,1997
165,Alvin Gentry,DET,1,2,37,16,21,37,16,21,73,31,42,0.425,,,,,,,,,,1997
166,P.J. Carlesimo,GSW,1,4,82,19,63,82,19,63,328,156,172,0.47600000000000003,,,,,,,12.0,3.0,9.0,1997
167,Rudy Tomjanovich,HOU,7,7,82,41,41,522,322,200,522,322,200,0.617,5.0,2.0,3.0,86.0,50.0,36.0,86.0,50.0,36.0,1997
168,Larry Bird,IND,1,1,82,58,24,82,58,24,82,58,24,0.7070000000000001,16.0,10.0,6.0,16.0,10.0,6.0,16.0,10.0,6.0,1997
169,Bill Fitch,LAC,4,25,82,17,65,328,99,229,2050,944,1106,0.46,,,,3.0,0.0,3.0,109.0,55.0,54.0,1997
170,Del Harris,LAL,4,13,82,61,21,328,218,110,1001,550,451,0.5489999999999999,13.0,7.0,6.0,36.0,17.0,19.0,88.0,38.0,50.0,1997
171,Pat Riley,MIA,3,16,82,55,27,246,158,88,1301,914,387,0.703,5.0,2.0,3.0,25.0,10.0,15.0,237.0,147.0,90.0,1997
172,Chris Ford,MIL,2,7,82,36,46,164,69,95,574,291,283,0.507,,,,,,,29.0,13.0,16.0,1997
173,Flip Saunders,MIN,3,3,82,45,37,226,105,121,226,105,121,0.465,5.0,2.0,3.0,8.0,2.0,6.0,8.0,2.0,6.0,1997
174,John Calipari,NJN,2,2,82,43,39,164,69,95,164,69,95,0.42100000000000004,3.0,0.0,3.0,3.0,0.0,3.0,3.0,0.0,3.0,1997
175,Jeff Van Gundy,NYK,3,3,82,43,39,187,113,74,187,113,74,0.604,10.0,4.0,6.0,28.0,14.0,14.0,28.0,14.0,14.0,1997
176,Chuck Daly,ORL,1,13,82,41,41,82,41,41,1025,605,420,0.59,,,,,,,122.0,74.0,48.0,1997
177,Larry Brown,PHI,1,19,82,31,51,82,31,51,1522,884,638,0.581,,,,,,,125.0,61.0,64.0,1997
178,Danny Ainge,PHO,2,2,82,56,26,156,96,60,156,96,60,0.615,4.0,1.0,3.0,9.0,3.0,6.0,9.0,3.0,6.0,1997
179,Mike Dunleavy,POR,1,7,82,46,36,82,46,36,574,254,320,0.44299999999999995,4.0,1.0,3.0,4.0,1.0,3.0,27.0,14.0,13.0,1997
180,Eddie Jordan,SAC,2,2,82,27,55,97,33,64,97,33,64,0.34,,,,,,,,,,1997
181,Gregg Popovich,SAS,2,2,82,56,26,146,73,73,146,73,73,0.5,9.0,4.0,5.0,9.0,4.0,5.0,9.0,4.0,5.0,1997
182,George Karl,SEA,7,11,82,61,21,534,384,150,829,503,326,0.607,10.0,4.0,6.0,80.0,40.0,40.0,94.0,45.0,49.0,1997
183,Darrell Walker,TOR,2,2,49,11,38,131,41,90,131,41,90,0.313,,,,,,,,,,1997
184,Butch Carter,TOR,1,1,33,5,28,33,5,28,33,5,28,0.152,,,,,,,,,,1997
185,Jerry Sloan,UTA,10,13,82,62,20,803,545,258,1018,639,379,0.628,20.0,13.0,7.0,117.0,63.0,54.0,123.0,65.0,58.0,1997
186,Brian Hill,VAN,1,5,82,19,63,82,19,63,377,210,167,0.557,,,,,,,36.0,18.0,18.0,1997
187,Bernie Bickerstaff,WAS,2,9,82,42,40,117,64,53,654,325,329,0.49700000000000005,,,,3.0,0.0,3.0,33.0,12.0,21.0,1997
188,Richie Guerin,ATL,5,5,82,48,34,372,207,165,372,207,165,0.556,11.0,5.0,6.0,40.0,19.0,21.0,40.0,19.0,21.0,1968
189,Gene Shue,BAL,3,3,82,57,25,220,109,111,220,109,111,0.495,4.0,0.0,4.0,4.0,0.0,4.0,4.0,0.0,4.0,1968
190,Bill Russell,BOS,3,3,82,48,34,245,162,83,245,162,83,0.6609999999999999,18.0,12.0,6.0,46.0,28.0,18.0,46.0,28.0,18.0,1968
191,Dick Motta,CHI,1,1,82,33,49,82,33,49,82,33,49,0.402,,,,,,,,,,1968
192,Ed Jucker,CIN,2,2,82,41,41,164,80,84,164,80,84,0.488,,,,,,,,,,1968
193,Donnie Butcher,DET,3,3,22,10,12,112,52,60,112,52,60,0.46399999999999997,,,,6.0,2.0,4.0,6.0,2.0,4.0,1968
194,Paul Seymour,DET,1,8,60,22,38,60,22,38,512,271,241,0.529,,,,,,,35.0,14.0,21.0,1968
195,Butch van Breda Kolff,LAL,2,2,82,55,27,164,107,57,164,107,57,0.652,18.0,11.0,7.0,33.0,21.0,12.0,33.0,21.0,12.0,1968
196,Larry Costello,MIL,1,1,82,27,55,82,27,55,82,27,55,0.32899999999999996,,,,,,,,,,1968
197,Red Holzman,NYK,2,6,82,54,28,126,82,44,329,165,164,0.502,10.0,6.0,4.0,16.0,8.0,8.0,24.0,12.0,12.0,1968
198,Jack Ramsay,PHI,1,1,82,55,27,82,55,27,82,55,27,0.6709999999999999,5.0,1.0,4.0,5.0,1.0,4.0,5.0,1.0,4.0,1968
199,Red Kerr,PHO,1,3,82,16,66,82,16,66,245,78,167,0.318,,,,,,,8.0,1.0,7.0,1968
200,Jack McMahon,SDR,2,7,82,37,45,164,52,112,523,251,272,0.48,6.0,2.0,4.0,6.0,2.0,4.0,29.0,10.0,19.0,1968
201,Al Bianchi,SEA,2,2,82,30,52,164,53,111,164,53,111,0.32299999999999995,,,,,,,,,,1968
202,George Lee,SFW,1,1,82,41,41,82,41,41,82,41,41,0.5,6.0,2.0,4.0,6.0,2.0,4.0,6.0,2.0,4.0,1968
203,Bob Weiss,ATL,3,5,82,43,39,246,124,122,410,183,227,0.446,3.0,0.0,3.0,8.0,2.0,6.0,11.0,2.0,9.0,1992
204,Chris Ford,BOS,3,3,82,48,34,246,155,91,246,155,91,0.63,4.0,1.0,3.0,25.0,12.0,13.0,25.0,12.0,13.0,1992
205,Allan Bristow,CHH,2,2,82,44,38,164,75,89,164,75,89,0.457,9.0,4.0,5.0,9.0,4.0,5.0,9.0,4.0,5.0,1992
206,Phil Jackson,CHI,4,4,82,57,25,328,240,88,328,240,88,0.732,19.0,15.0,4.0,74.0,55.0,19.0,74.0,55.0,19.0,1992
207,Lenny Wilkens,CLE,7,20,82,54,28,574,316,258,1618,869,749,0.537,9.0,3.0,6.0,41.0,18.0,23.0,110.0,55.0,55.0,1992
208,Richie Adubato,DAL,4,5,29,2,27,264,94,170,334,106,228,0.317,,,,3.0,0.0,3.0,3.0,0.0,3.0,1992
209,Gar Heard,DAL,1,1,53,9,44,53,9,44,53,9,44,0.17,,,,,,,,,,1992
210,Dan Issel,DEN,1,1,82,36,46,82,36,46,82,36,46,0.439,,,,,,,,,,1992
211,Ron Rothstein,DET,1,4,82,40,42,82,40,42,328,97,231,0.29600000000000004,,,,,,,,,,1992
212,Don Nelson,GSW,5,16,82,34,48,410,213,197,1294,753,541,0.5820000000000001,,,,21.0,9.0,12.0,109.0,51.0,58.0,1992
213,Rudy Tomjanovich,HOU,2,2,82,55,27,112,71,41,112,71,41,0.634,12.0,6.0,6.0,12.0,6.0,6.0,12.0,6.0,6.0,1992
214,Bob Hill,IND,3,4,82,41,41,221,113,108,287,133,154,0.46299999999999997,4.0,1.0,3.0,12.0,3.0,9.0,12.0,3.0,9.0,1992
215,Larry Brown,LAC,2,14,82,41,41,117,64,53,1112,663,449,0.596,5.0,2.0,3.0,10.0,4.0,6.0,87.0,39.0,48.0,1992
216,Randy Pfund,LAL,1,1,82,39,43,82,39,43,82,39,43,0.47600000000000003,5.0,2.0,3.0,5.0,2.0,3.0,5.0,2.0,3.0,1992
217,Kevin Loughery,MIA,2,18,82,36,46,164,74,90,1260,583,677,0.46299999999999997,,,,3.0,0.0,3.0,54.0,25.0,29.0,1992
218,Mike Dunleavy,MIL,1,3,82,28,54,82,28,54,246,129,117,0.524,,,,,,,23.0,13.0,10.0,1992
219,Jimmy Rodgers,MIN,2,4,29,6,23,111,21,90,275,115,160,0.418,,,,,,,8.0,2.0,6.0,1992
220,Sidney Lowe,MIN,1,1,53,13,40,53,13,40,53,13,40,0.245,,,,,,,,,,1992
221,Chuck Daly,NJN,1,11,82,43,39,82,43,39,861,519,342,0.603,5.0,2.0,3.0,5.0,2.0,3.0,118.0,73.0,45.0,1992
222,Pat Riley,NYK,2,11,82,60,22,164,111,53,891,644,247,0.723,15.0,9.0,6.0,27.0,15.0,12.0,176.0,117.0,59.0,1992
223,Matt Guokas,ORL,4,7,82,41,41,328,111,217,535,230,305,0.43,,,,,,,17.0,8.0,9.0,1992
224,Doug Moe,PHI,1,15,56,19,37,56,19,37,1157,628,529,0.5429999999999999,,,,,,,83.0,33.0,50.0,1992
225,Fred Carter,PHI,1,1,26,7,19,26,7,19,26,7,19,0.26899999999999996,,,,,,,,,,1992
226,Paul Westphal,PHO,1,1,82,62,20,82,62,20,82,62,20,0.7559999999999999,24.0,13.0,11.0,24.0,13.0,11.0,24.0,13.0,11.0,1992
227,Rick Adelman,POR,5,5,82,51,31,363,244,119,363,244,119,0.672,4.0,1.0,3.0,65.0,35.0,30.0,65.0,35.0,30.0,1992
228,Garry St. Jean,SAC,1,1,82,25,57,82,25,57,82,25,57,0.305,,,,,,,,,,1992
229,Jerry Tarkanian,SAS,1,1,20,9,11,20,9,11,20,9,11,0.45,,,,,,,,,,1992
230,Rex Hughes,SAS,1,2,1,1,0,1,1,0,58,23,35,0.397,,,,,,,,,,1992
231,John Lucas,SAS,1,1,61,39,22,61,39,22,61,39,22,0.639,10.0,5.0,5.0,10.0,5.0,5.0,10.0,5.0,5.0,1992
232,George Karl,SEA,2,6,82,55,27,124,82,42,419,201,218,0.48,19.0,10.0,9.0,28.0,14.0,14.0,42.0,19.0,23.0,1992
233,Jerry Sloan,UTA,5,8,82,47,35,393,251,142,608,345,263,0.5670000000000001,5.0,2.0,3.0,38.0,17.0,21.0,44.0,19.0,25.0,1992
234,Wes Unseld,WSB,6,6,82,22,60,465,178,287,465,178,287,0.38299999999999995,,,,5.0,2.0,3.0,5.0,2.0,3.0,1992
235,Mike Budenholzer,ATL,3,3,82,48,34,246,146,100,246,146,100,0.593,10.0,4.0,6.0,33.0,15.0,18.0,33.0,15.0,18.0,2015
236,Brad Stevens,BOS,3,3,82,48,34,246,113,133,246,113,133,0.45899999999999996,6.0,2.0,4.0,10.0,2.0,8.0,10.0,2.0,8.0,2015
237,Lionel Hollins,BRK,2,9,37,10,27,119,48,71,534,262,272,0.491,,,,6.0,2.0,4.0,41.0,20.0,21.0,2015
238,Tony Brown,BRK,1,1,45,11,34,45,11,34,45,11,34,0.244,,,,,,,,,,2015
239,Fred Hoiberg,CHI,1,1,82,42,40,82,42,40,82,42,40,0.512,,,,,,,,,,2015
240,Steve Clifford,CHO,3,3,82,48,34,246,124,122,246,124,122,0.504,7.0,3.0,4.0,11.0,3.0,8.0,11.0,3.0,8.0,2015
241,David Blatt,CLE,2,2,41,30,11,123,83,40,123,83,40,0.675,,,,20.0,14.0,6.0,20.0,14.0,6.0,2015
242,Tyronn Lue,CLE,1,1,41,27,14,41,27,14,41,27,14,0.659,21.0,16.0,5.0,21.0,16.0,5.0,21.0,16.0,5.0,2015
243,Rick Carlisle,DAL,8,14,82,42,40,640,380,260,1132,661,471,0.584,5.0,1.0,4.0,58.0,28.0,30.0,120.0,58.0,62.0,2015
244,Mike Malone,DEN,1,3,82,33,49,82,33,49,188,72,116,0.38299999999999995,,,,,,,,,,2015
245,Stan Van Gundy,DET,2,10,82,44,38,164,76,88,743,447,296,0.602,4.0,0.0,4.0,4.0,0.0,4.0,91.0,48.0,43.0,2015
246,Steve Kerr,GSW,2,2,82,73,9,164,140,24,164,140,24,0.8540000000000001,24.0,15.0,9.0,45.0,31.0,14.0,45.0,31.0,14.0,2015
247,Kevin McHale,HOU,5,7,11,4,7,323,193,130,417,232,185,0.556,,,,29.0,13.0,16.0,29.0,13.0,16.0,2015
248,J.B. Bickerstaff,HOU,1,1,71,37,34,71,37,34,71,37,34,0.521,5.0,1.0,4.0,5.0,1.0,4.0,5.0,1.0,4.0,2015
249,Frank Vogel,IND,6,6,82,45,37,431,250,181,431,250,181,0.58,7.0,3.0,4.0,61.0,31.0,30.0,61.0,31.0,30.0,2015
250,Doc Rivers,LAC,3,17,82,53,29,246,166,80,1306,753,553,0.5770000000000001,6.0,2.0,4.0,33.0,15.0,18.0,154.0,79.0,75.0,2015
251,Byron Scott,LAL,2,15,82,17,65,164,38,126,1101,454,647,0.41200000000000003,,,,,,,57.0,33.0,24.0,2015
252,Dave Joerger,MEM,3,3,82,42,40,246,147,99,246,147,99,0.598,4.0,0.0,4.0,22.0,9.0,13.0,22.0,9.0,13.0,2015
253,Erik Spoelstra,MIA,8,8,82,48,34,640,399,241,640,399,241,0.623,14.0,7.0,7.0,113.0,70.0,43.0,113.0,70.0,43.0,2015
254,Jason Kidd,MIL,2,3,82,33,49,164,74,90,246,118,128,0.48,,,,6.0,2.0,4.0,18.0,7.0,11.0,2015
255,Sam Mitchell,MIN,1,6,82,29,53,82,29,53,427,185,242,0.433,,,,,,,11.0,3.0,8.0,2015
256,Alvin Gentry,NOP,1,13,82,30,52,82,30,52,787,365,422,0.46399999999999997,,,,,,,21.0,12.0,9.0,2015
257,Derek Fisher,NYK,2,2,54,23,31,136,40,96,136,40,96,0.294,,,,,,,,,,2015
258,Kurt Rambis,NYK,1,4,28,9,19,28,9,19,229,65,164,0.284,,,,,,,8.0,3.0,5.0,2015
259,Billy Donovan,OKC,1,1,82,55,27,82,55,27,82,55,27,0.6709999999999999,18.0,11.0,7.0,18.0,11.0,7.0,18.0,11.0,7.0,2015
260,Scott Skiles,ORL,1,14,82,35,47,82,35,47,958,478,480,0.499,,,,,,,42.0,18.0,24.0,2015
261,Brett Brown,PHI,3,3,82,10,72,246,47,199,246,47,199,0.191,,,,,,,,,,2015
262,Jeff Hornacek,PHO,3,3,49,14,35,213,101,112,213,101,112,0.474,,,,,,,,,,2015
263,Earl Watson,PHO,1,1,33,9,24,33,9,24,33,9,24,0.273,,,,,,,,,,2015
264,Terry Stotts,POR,4,8,82,44,38,328,182,146,611,297,314,0.486,11.0,5.0,6.0,27.0,11.0,16.0,32.0,12.0,20.0,2015
265,George Karl,SAC,2,27,82,33,49,112,44,68,1999,1175,824,0.588,,,,,,,185.0,80.0,105.0,2015
266,Gregg Popovich,SAS,20,20,82,67,15,1574,1089,485,1574,1089,485,0.6920000000000001,10.0,6.0,4.0,256.0,158.0,98.0,256.0,158.0,98.0,2015
267,Dwane Casey,TOR,5,7,82,56,26,394,210,184,516,263,253,0.51,20.0,10.0,10.0,31.0,13.0,18.0,31.0,13.0,18.0,2015
268,Quin Snyder,UTA,2,2,82,40,42,164,78,86,164,78,86,0.47600000000000003,,,,,,,,,,2015
269,Randy Wittman,WAS,5,10,82,41,41,377,178,199,684,278,406,0.406,,,,21.0,12.0,9.0,21.0,12.0,9.0,2015
270,Red Auerbach,BOS,12,16,80,60,20,872,562,310,1097,705,392,0.643,14.0,8.0,6.0,96.0,55.0,41.0,116.0,64.0,52.0,1961
271,Jim Pollard,CHP,1,2,80,18,62,80,18,62,119,32,87,0.26899999999999996,,,,,,,9.0,5.0,4.0,1961
272,Charles Wolf,CIN,2,2,80,43,37,159,76,83,159,76,83,0.478,4.0,1.0,3.0,4.0,1.0,3.0,4.0,1.0,3.0,1961
273,Dick McGuire,DET,3,3,80,37,43,200,88,112,200,88,112,0.44,10.0,5.0,5.0,17.0,7.0,10.0,17.0,7.0,10.0,1961
274,Fred Schaus,LAL,2,2,80,54,26,159,90,69,159,90,69,0.5660000000000001,13.0,7.0,6.0,25.0,13.0,12.0,25.0,13.0,12.0,1961
275,Eddie Donovan,NYK,1,1,80,29,51,80,29,51,80,29,51,0.363,,,,,,,,,,1961
276,Frank McGuire,PHW,1,1,80,49,31,80,49,31,80,49,31,0.613,12.0,6.0,6.0,12.0,6.0,6.0,12.0,6.0,6.0,1961
277,Paul Seymour,STL,2,6,14,5,9,93,56,37,372,211,161,0.5670000000000001,,,,12.0,5.0,7.0,32.0,14.0,18.0,1961
278,Andrew Levane,STL,3,5,60,20,40,177,58,119,276,106,170,0.384,,,,,,,2.0,0.0,2.0,1961
279,Bob Pettit,STL,1,1,6,4,2,6,4,2,6,4,2,0.667,,,,,,,,,,1961
280,Alex Hannum,SYR,2,4,80,41,39,159,79,80,262,135,127,0.515,5.0,2.0,3.0,13.0,6.0,7.0,34.0,20.0,14.0,1961
281,Mike Budenholzer,ATL,4,4,82,43,39,328,189,139,328,189,139,0.5760000000000001,6.0,2.0,4.0,39.0,17.0,22.0,39.0,17.0,22.0,2016
282,Brad Stevens,BOS,4,4,82,53,29,328,166,162,328,166,162,0.506,18.0,9.0,9.0,28.0,11.0,17.0,28.0,11.0,17.0,2016
283,Kenny Atkinson,BRK,1,1,82,20,62,82,20,62,82,20,62,0.244,,,,,,,,,,2016
284,Fred Hoiberg,CHI,2,2,82,41,41,164,83,81,164,83,81,0.506,6.0,2.0,4.0,6.0,2.0,4.0,6.0,2.0,4.0,2016
285,Steve Clifford,CHO,4,4,82,36,46,328,160,168,328,160,168,0.488,,,,11.0,3.0,8.0,11.0,3.0,8.0,2016
286,Tyronn Lue,CLE,2,2,82,51,31,123,78,45,123,78,45,0.634,18.0,13.0,5.0,39.0,29.0,10.0,39.0,29.0,10.0,2016
287,Rick Carlisle,DAL,9,15,82,33,49,722,413,309,1214,694,520,0.5720000000000001,,,,58.0,28.0,30.0,120.0,58.0,62.0,2016
288,Mike Malone,DEN,2,4,82,40,42,164,73,91,270,112,158,0.415,,,,,,,,,,2016
289,Stan Van Gundy,DET,3,11,82,37,45,246,113,133,825,484,341,0.5870000000000001,,,,4.0,0.0,4.0,91.0,48.0,43.0,2016
290,Steve Kerr,GSW,3,3,82,67,15,246,207,39,246,207,39,0.841,17.0,16.0,1.0,62.0,47.0,15.0,62.0,47.0,15.0,2016
291,Mike D'Antoni,HOU,1,13,82,55,27,82,55,27,963,510,453,0.53,11.0,6.0,5.0,11.0,6.0,5.0,70.0,32.0,38.0,2016
292,Nate McMillan,IND,1,13,82,42,40,82,42,40,1012,520,492,0.514,4.0,0.0,4.0,4.0,0.0,4.0,38.0,14.0,24.0,2016
293,Doc Rivers,LAC,4,18,82,51,31,328,217,111,1388,804,584,0.579,7.0,3.0,4.0,40.0,18.0,22.0,161.0,82.0,79.0,2016
294,Luke Walton,LAL,1,1,82,26,56,82,26,56,82,26,56,0.317,,,,,,,,,,2016
295,David Fizdale,MEM,1,1,82,43,39,82,43,39,82,43,39,0.524,6.0,2.0,4.0,6.0,2.0,4.0,6.0,2.0,4.0,2016
296,Erik Spoelstra,MIA,9,9,82,41,41,722,440,282,722,440,282,0.609,,,,113.0,70.0,43.0,113.0,70.0,43.0,2016
297,Jason Kidd,MIL,3,4,82,42,40,246,116,130,328,160,168,0.488,6.0,2.0,4.0,12.0,4.0,8.0,24.0,9.0,15.0,2016
298,Tom Thibodeau,MIN,1,6,82,31,51,82,31,51,476,286,190,0.601,,,,,,,51.0,23.0,28.0,2016
299,Alvin Gentry,NOP,2,14,82,34,48,164,64,100,869,399,470,0.45899999999999996,,,,,,,21.0,12.0,9.0,2016
300,Jeff Hornacek,NYK,1,4,82,31,51,82,31,51,295,132,163,0.447,,,,,,,,,,2016
301,Billy Donovan,OKC,2,2,82,47,35,164,102,62,164,102,62,0.622,5.0,1.0,4.0,23.0,12.0,11.0,23.0,12.0,11.0,2016
302,Frank Vogel,ORL,1,7,82,29,53,82,29,53,513,279,234,0.544,,,,,,,61.0,31.0,30.0,2016
303,Brett Brown,PHI,4,4,82,28,54,328,75,253,328,75,253,0.22899999999999998,,,,,,,,,,2016
304,Earl Watson,PHO,2,2,82,24,58,115,33,82,115,33,82,0.287,,,,,,,,,,2016
305,Terry Stotts,POR,5,9,82,41,41,410,223,187,693,338,355,0.488,4.0,0.0,4.0,31.0,11.0,20.0,36.0,12.0,24.0,2016
306,Dave Joerger,SAC,1,4,82,32,50,82,32,50,328,179,149,0.546,,,,,,,22.0,9.0,13.0,2016
307,Gregg Popovich,SAS,21,21,82,61,21,1656,1150,506,1656,1150,506,0.6940000000000001,16.0,8.0,8.0,272.0,166.0,106.0,272.0,166.0,106.0,2016
308,Dwane Casey,TOR,6,8,82,51,31,476,261,215,598,314,284,0.525,10.0,4.0,6.0,41.0,17.0,24.0,41.0,17.0,24.0,2016
309,Quin Snyder,UTA,3,3,82,51,31,246,129,117,246,129,117,0.524,11.0,4.0,7.0,11.0,4.0,7.0,11.0,4.0,7.0,2016
310,Scott Brooks,WAS,1,8,82,49,33,82,49,33,627,387,240,0.617,13.0,7.0,6.0,13.0,7.0,6.0,86.0,46.0,40.0,2016
311,Red Auerbach,BOS,8,12,72,49,23,566,334,232,791,477,314,0.603,11.0,6.0,5.0,48.0,23.0,25.0,68.0,32.0,36.0,1957
312,Bobby Wanzer,CIN,3,3,72,33,39,216,95,121,216,95,121,0.44,2.0,0.0,2.0,2.0,0.0,2.0,2.0,0.0,2.0,1957
313,Charles Eckman,DET,4,4,25,9,16,241,123,118,241,123,118,0.51,,,,23.0,10.0,13.0,23.0,10.0,13.0,1957
314,Red Rocha,DET,1,1,47,24,23,47,24,23,47,24,23,0.511,7.0,3.0,4.0,7.0,3.0,4.0,7.0,3.0,4.0,1957
315,George Mikan,MNL,1,1,39,9,30,39,9,30,39,9,30,0.231,,,,,,,,,,1957
316,John Kundla,MNL,10,10,33,10,23,653,390,263,653,390,263,0.597,,,,82.0,54.0,28.0,82.0,54.0,28.0,1957
317,Vince Boryla,NYK,3,3,72,35,37,165,80,85,165,80,85,0.485,,,,,,,,,,1957
318,George Senesky,PHW,3,3,72,37,35,216,119,97,216,119,97,0.551,8.0,3.0,5.0,20.0,10.0,10.0,20.0,10.0,10.0,1957
319,Alex Hannum,STL,2,2,72,41,31,103,56,47,103,56,47,0.544,11.0,8.0,3.0,21.0,14.0,7.0,21.0,14.0,7.0,1957
320,Paul Seymour,SYR,2,2,72,41,31,132,75,57,132,75,57,0.568,3.0,1.0,2.0,8.0,3.0,5.0,8.0,3.0,5.0,1957
321,Mike Fratello,ATL,8,8,82,41,41,577,324,253,577,324,253,0.562,,,,40.0,18.0,22.0,40.0,18.0,22.0,1989
322,Jimmy Rodgers,BOS,2,2,82,52,30,164,94,70,164,94,70,0.573,5.0,2.0,3.0,8.0,2.0,6.0,8.0,2.0,6.0,1989
323,Dick Harter,CHH,2,2,40,8,32,122,28,94,122,28,94,0.23,,,,,,,,,,1989
324,Gene Littles,CHH,1,2,42,11,31,42,11,31,57,15,42,0.263,,,,,,,,,,1989
325,Phil Jackson,CHI,1,1,82,55,27,82,55,27,82,55,27,0.6709999999999999,16.0,10.0,6.0,16.0,10.0,6.0,16.0,10.0,6.0,1989
326,Lenny Wilkens,CLE,4,17,82,42,40,328,172,156,1372,725,647,0.528,5.0,2.0,3.0,15.0,6.0,9.0,84.0,43.0,41.0,1989
327,John MacLeod,DAL,3,17,11,5,6,175,96,79,1297,675,622,0.52,,,,17.0,10.0,7.0,98.0,47.0,51.0,1989
328,Richie Adubato,DAL,1,2,71,42,29,71,42,29,141,54,87,0.38299999999999995,3.0,0.0,3.0,3.0,0.0,3.0,3.0,0.0,3.0,1989
329,Doug Moe,DEN,10,14,82,43,39,789,432,357,1101,609,492,0.5529999999999999,3.0,0.0,3.0,61.0,24.0,37.0,83.0,33.0,50.0,1989
330,Chuck Daly,DET,7,8,82,59,23,574,369,205,615,378,237,0.615,20.0,15.0,5.0,93.0,62.0,31.0,93.0,62.0,31.0,1989
331,Don Nelson,GSW,2,13,82,37,45,164,80,84,1048,620,428,0.5920000000000001,,,,8.0,4.0,4.0,96.0,46.0,50.0,1989
332,Don Chaney,HOU,2,5,82,41,41,164,86,78,349,139,210,0.39799999999999996,4.0,1.0,3.0,8.0,2.0,6.0,8.0,2.0,6.0,1989
333,Dick Versace,IND,2,2,82,42,40,135,64,71,135,64,71,0.474,3.0,0.0,3.0,3.0,0.0,3.0,3.0,0.0,3.0,1989
334,Don Casey,LAC,2,2,82,30,52,126,41,85,126,41,85,0.325,,,,,,,,,,1989
335,Pat Riley,LAL,9,9,82,63,19,727,533,194,727,533,194,0.733,9.0,4.0,5.0,149.0,102.0,47.0,149.0,102.0,47.0,1989
336,Ron Rothstein,MIA,2,2,82,18,64,164,33,131,164,33,131,0.201,,,,,,,,,,1989
337,Del Harris,MIL,3,7,82,44,38,246,135,111,574,276,298,0.48100000000000004,4.0,1.0,3.0,18.0,6.0,12.0,49.0,21.0,28.0,1989
338,Bill Musselman,MIN,1,4,82,22,60,82,22,60,213,56,157,0.263,,,,,,,,,,1989
339,Bill Fitch,NJN,1,19,82,17,65,82,17,65,1558,779,779,0.5,,,,,,,102.0,54.0,48.0,1989
340,Stu Jackson,NYK,1,1,82,45,37,82,45,37,82,45,37,0.5489999999999999,10.0,4.0,6.0,10.0,4.0,6.0,10.0,4.0,6.0,1989
341,Matt Guokas,ORL,1,4,82,18,64,82,18,64,289,137,152,0.474,,,,,,,17.0,8.0,9.0,1989
342,Jim Lynam,PHI,3,5,82,53,29,203,115,88,346,167,179,0.483,10.0,4.0,6.0,13.0,4.0,9.0,13.0,4.0,9.0,1989
343,Cotton Fitzsimmons,PHO,4,17,82,54,28,328,206,122,1386,697,689,0.503,16.0,9.0,7.0,28.0,16.0,12.0,68.0,29.0,39.0,1989
344,Rick Adelman,POR,2,2,82,59,23,117,73,44,117,73,44,0.624,21.0,12.0,9.0,24.0,12.0,12.0,24.0,12.0,12.0,1989
345,Jerry Reynolds,SAC,4,4,28,7,21,170,56,114,170,56,114,0.32899999999999996,,,,,,,,,,1989
346,Dick Motta,SAC,1,20,54,16,38,54,16,38,1612,824,788,0.511,,,,,,,126.0,56.0,70.0,1989
347,Larry Brown,SAS,2,11,82,56,26,164,77,87,875,523,352,0.598,10.0,6.0,4.0,10.0,6.0,4.0,73.0,34.0,39.0,1989
348,Bernie Bickerstaff,SEA,5,5,82,41,41,410,202,208,410,202,208,0.493,,,,27.0,12.0,15.0,27.0,12.0,15.0,1989
349,Jerry Sloan,UTA,2,5,82,55,27,147,95,52,362,189,173,0.522,5.0,2.0,3.0,8.0,2.0,6.0,14.0,4.0,10.0,1989
350,Wes Unseld,WSB,3,3,82,31,51,219,101,118,219,101,118,0.461,,,,5.0,2.0,3.0,5.0,2.0,3.0,1989
351,Mike Fratello,ATL,5,5,82,57,25,331,181,150,331,181,150,0.547,9.0,4.0,5.0,23.0,10.0,13.0,23.0,10.0,13.0,1986
352,K.C. Jones,BOS,4,8,82,59,23,328,251,77,658,436,222,0.6629999999999999,23.0,13.0,10.0,85.0,56.0,29.0,120.0,70.0,50.0,1986
353,Doug Collins,CHI,1,1,82,40,42,82,40,42,82,40,42,0.488,3.0,0.0,3.0,3.0,0.0,3.0,3.0,0.0,3.0,1986
354,Lenny Wilkens,CLE,1,14,82,31,51,82,31,51,1126,584,542,0.519,,,,,,,69.0,37.0,32.0,1986
355,Dick Motta,DAL,7,19,82,55,27,574,267,307,1558,808,750,0.519,4.0,1.0,3.0,28.0,11.0,17.0,126.0,56.0,70.0,1986
356,Doug Moe,DEN,7,11,82,37,45,543,291,252,855,468,387,0.547,3.0,0.0,3.0,44.0,19.0,25.0,66.0,28.0,38.0,1986
357,Chuck Daly,DET,4,5,82,52,30,328,193,135,369,202,167,0.547,15.0,10.0,5.0,33.0,18.0,15.0,33.0,18.0,15.0,1986
358,George Karl,GSW,1,3,82,42,40,82,42,40,231,103,128,0.446,10.0,4.0,6.0,10.0,4.0,6.0,14.0,5.0,9.0,1986
359,Bill Fitch,HOU,4,17,82,42,40,328,170,158,1394,716,678,0.514,10.0,5.0,5.0,35.0,20.0,15.0,98.0,53.0,45.0,1986
360,Jack Ramsay,IND,1,19,82,41,41,82,41,41,1558,826,732,0.53,4.0,1.0,3.0,4.0,1.0,3.0,102.0,44.0,58.0,1986
361,Don Chaney,LAC,3,3,82,12,70,185,53,132,185,53,132,0.28600000000000003,,,,,,,,,,1986
362,Pat Riley,LAL,6,6,82,65,17,481,351,130,481,351,130,0.73,18.0,15.0,3.0,101.0,72.0,29.0,101.0,72.0,29.0,1986
363,Don Nelson,MIL,11,11,82,50,32,884,540,344,884,540,344,0.611,12.0,6.0,6.0,88.0,42.0,46.0,88.0,42.0,46.0,1986
364,Dave Wohl,NJN,2,2,82,24,58,164,63,101,164,63,101,0.384,,,,3.0,0.0,3.0,3.0,0.0,3.0,1986
365,Hubie Brown,NYK,5,12,16,4,12,344,142,202,919,445,474,0.484,,,,18.0,8.0,10.0,59.0,31.0,28.0,1986
366,Bob Hill,NYK,1,1,66,20,46,66,20,46,66,20,46,0.303,,,,,,,,,,1986
367,Matt Guokas,PHI,2,2,82,45,37,164,99,65,164,99,65,0.604,5.0,2.0,3.0,17.0,8.0,9.0,17.0,8.0,9.0,1986
368,John MacLeod,PHO,14,14,56,22,34,1122,579,543,1122,579,543,0.516,,,,81.0,37.0,44.0,81.0,37.0,44.0,1986
369,Dick Van Arsdale,PHO,1,1,26,14,12,26,14,12,26,14,12,0.5379999999999999,,,,,,,,,,1986
370,Mike Schuler,POR,1,1,82,49,33,82,49,33,82,49,33,0.598,4.0,1.0,3.0,4.0,1.0,3.0,4.0,1.0,3.0,1986
371,Phil Johnson,SAC,8,9,46,14,32,542,236,306,543,236,307,0.435,,,,9.0,2.0,7.0,9.0,2.0,7.0,1986
372,Jerry Reynolds,SAC,1,1,36,15,21,36,15,21,36,15,21,0.41700000000000004,,,,,,,,,,1986
373,Bob Weiss,SAS,1,1,82,28,54,82,28,54,82,28,54,0.341,,,,,,,,,,1986
374,Bernie Bickerstaff,SEA,2,2,82,39,43,164,70,94,164,70,94,0.42700000000000005,14.0,7.0,7.0,14.0,7.0,7.0,14.0,7.0,7.0,1986
375,Frank Layden,UTA,6,6,82,44,38,472,219,253,472,219,253,0.46399999999999997,5.0,2.0,3.0,30.0,12.0,18.0,30.0,12.0,18.0,1986
376,Kevin Loughery,WSB,2,15,82,42,40,95,49,46,1069,501,568,0.469,3.0,0.0,3.0,8.0,2.0,6.0,51.0,25.0,26.0,1986
377,Lenny Wilkens,ATL,7,27,82,28,54,542,310,232,2160,1179,981,0.546,,,,47.0,17.0,30.0,157.0,72.0,85.0,1999
378,Rick Pitino,BOS,3,5,82,35,47,214,90,124,378,180,198,0.47600000000000003,,,,,,,13.0,6.0,7.0,1999
379,Paul Silas,CHH,2,5,82,49,33,117,71,46,363,149,214,0.41,4.0,1.0,3.0,4.0,1.0,3.0,4.0,1.0,3.0,1999
380,Tim Floyd,CHI,2,2,82,17,65,132,30,102,132,30,102,0.22699999999999998,,,,,,,,,,1999
381,Randy Wittman,CLE,1,1,82,32,50,82,32,50,82,32,50,0.39,,,,,,,,,,1999
382,Don Nelson,DAL,3,22,82,40,42,198,75,123,1678,926,752,0.552,,,,,,,112.0,51.0,61.0,1999
383,Dan Issel,DEN,4,4,82,35,47,280,131,149,280,131,149,0.46799999999999997,,,,12.0,6.0,6.0,12.0,6.0,6.0,1999
384,Alvin Gentry,DET,3,4,58,28,30,145,73,72,181,88,93,0.486,,,,5.0,2.0,3.0,5.0,2.0,3.0,1999
385,George Irvine,DET,1,4,24,14,10,24,14,10,208,68,140,0.327,3.0,0.0,3.0,3.0,0.0,3.0,3.0,0.0,3.0,1999
386,P.J. Carlesimo,GSW,3,6,27,6,21,159,46,113,405,183,222,0.452,,,,,,,12.0,3.0,9.0,1999
387,Garry St. Jean,GSW,1,6,55,13,42,55,13,42,450,172,278,0.382,,,,,,,4.0,1.0,3.0,1999
388,Rudy Tomjanovich,HOU,9,9,82,34,48,654,387,267,654,387,267,0.5920000000000001,,,,90.0,51.0,39.0,90.0,51.0,39.0,1999
389,Larry Bird,IND,3,3,82,56,26,214,147,67,214,147,67,0.687,23.0,13.0,10.0,52.0,32.0,20.0,52.0,32.0,20.0,1999
390,Chris Ford,LAC,2,9,45,11,34,95,20,75,669,311,358,0.465,,,,,,,29.0,13.0,16.0,1999
391,Jim Todd,LAC,1,1,37,4,33,37,4,33,37,4,33,0.10800000000000001,,,,,,,,,,1999
392,Phil Jackson,LAL,1,10,82,67,15,82,67,15,820,612,208,0.746,23.0,15.0,8.0,23.0,15.0,8.0,175.0,126.0,49.0,1999
393,Pat Riley,MIA,5,18,82,52,30,378,243,135,1433,999,434,0.6970000000000001,10.0,6.0,4.0,40.0,18.0,22.0,252.0,155.0,97.0,1999
394,George Karl,MIL,2,13,82,42,40,132,70,62,961,573,388,0.596,5.0,2.0,3.0,8.0,2.0,6.0,102.0,47.0,55.0,1999
395,Flip Saunders,MIN,5,5,82,50,32,358,180,178,358,180,178,0.503,4.0,1.0,3.0,16.0,4.0,12.0,16.0,4.0,12.0,1999
396,Don Casey,NJN,2,4,82,31,51,112,44,68,238,85,153,0.35700000000000004,,,,,,,,,,1999
397,Jeff Van Gundy,NYK,5,5,82,50,32,319,190,129,319,190,129,0.596,16.0,9.0,7.0,64.0,35.0,29.0,64.0,35.0,29.0,1999
398,Doc Rivers,ORL,1,1,82,41,41,82,41,41,82,41,41,0.5,,,,,,,,,,1999
399,Larry Brown,PHI,3,21,82,49,33,214,108,106,1654,961,693,0.581,10.0,5.0,5.0,18.0,8.0,10.0,143.0,69.0,74.0,1999
400,Danny Ainge,PHO,4,4,20,13,7,226,136,90,226,136,90,0.602,,,,12.0,3.0,9.0,12.0,3.0,9.0,1999
401,Scott Skiles,PHO,1,1,62,40,22,62,40,22,62,40,22,0.645,9.0,4.0,5.0,9.0,4.0,5.0,9.0,4.0,5.0,1999
402,Mike Dunleavy,POR,3,9,82,59,23,214,140,74,706,348,358,0.493,16.0,10.0,6.0,33.0,18.0,15.0,56.0,31.0,25.0,1999
403,Rick Adelman,SAC,2,10,82,44,38,132,71,61,741,428,313,0.578,5.0,2.0,3.0,10.0,4.0,6.0,79.0,40.0,39.0,1999
404,Gregg Popovich,SAS,4,4,82,53,29,278,163,115,278,163,115,0.586,4.0,1.0,3.0,30.0,20.0,10.0,30.0,20.0,10.0,1999
405,Paul Westphal,SEA,2,6,82,45,37,132,70,62,411,261,150,0.635,5.0,2.0,3.0,5.0,2.0,3.0,49.0,27.0,22.0,1999
406,Butch Carter,TOR,3,3,82,45,37,165,73,92,165,73,92,0.442,3.0,0.0,3.0,3.0,0.0,3.0,3.0,0.0,3.0,1999
407,Jerry Sloan,UTA,12,15,82,55,27,935,637,298,1150,731,419,0.636,10.0,4.0,6.0,138.0,72.0,66.0,144.0,74.0,70.0,1999
408,Brian Hill,VAN,3,7,22,4,18,154,31,123,449,222,227,0.494,,,,,,,36.0,18.0,18.0,1999
409,Lionel Hollins,VAN,1,1,60,18,42,60,18,42,60,18,42,0.3,,,,,,,,,,1999
410,Gar Heard,WAS,1,2,44,14,30,44,14,30,97,23,74,0.237,,,,,,,,,,1999
411,Darrell Walker,WAS,1,3,38,15,23,38,15,23,169,56,113,0.331,,,,,,,,,,1999
412,Fred Scolari,BLB,1,1,39,12,27,39,12,27,39,12,27,0.308,,,,,,,,,,1951
413,Chick Reiser,BLB,1,1,27,8,19,27,8,19,27,8,19,0.29600000000000004,,,,,,,,,,1951
414,Red Auerbach,BOS,2,6,66,39,27,135,78,57,360,221,139,0.614,3.0,1.0,2.0,5.0,1.0,4.0,25.0,10.0,15.0,1951
415,Paul Birch,FTW,1,2,66,29,37,66,29,37,126,44,82,0.349,2.0,0.0,2.0,2.0,0.0,2.0,2.0,0.0,2.0,1951
416,Herm Schaefer,INO,1,1,66,34,32,66,34,32,66,34,32,0.515,2.0,0.0,2.0,2.0,0.0,2.0,2.0,0.0,2.0,1951
417,Doxie Moore,MLH,1,2,66,17,49,66,17,49,92,32,60,0.348,,,,,,,8.0,4.0,4.0,1951
418,John Kundla,MNL,4,4,66,40,26,262,179,83,262,179,83,0.6829999999999999,13.0,9.0,4.0,42.0,30.0,12.0,42.0,30.0,12.0,1951
419,Joe Lapchick,NYK,5,5,66,37,29,308,171,137,308,171,137,0.555,14.0,8.0,6.0,42.0,23.0,19.0,42.0,23.0,19.0,1951
420,Edward Gottlieb,PHW,6,6,66,33,33,368,189,179,368,189,179,0.514,3.0,1.0,2.0,32.0,15.0,17.0,32.0,15.0,17.0,1951
421,Les Harrison,ROC,4,4,66,41,25,262,178,84,262,178,84,0.679,6.0,3.0,3.0,26.0,14.0,12.0,26.0,14.0,12.0,1951
422,Al Cervi,SYR,3,3,66,40,26,196,123,73,196,123,73,0.628,7.0,3.0,4.0,25.0,13.0,12.0,25.0,13.0,12.0,1951
423,Mike Woodson,ATL,6,6,82,53,29,492,206,286,492,206,286,0.419,11.0,4.0,7.0,29.0,11.0,18.0,29.0,11.0,18.0,2009
424,Doc Rivers,BOS,6,11,82,50,32,492,280,212,831,451,380,0.5429999999999999,24.0,15.0,9.0,71.0,41.0,30.0,86.0,46.0,40.0,2009
425,Larry Brown,CHA,2,29,82,44,38,164,79,85,2310,1318,992,0.5710000000000001,4.0,0.0,4.0,4.0,0.0,4.0,235.0,120.0,115.0,2009
426,Vinny Del Negro,CHI,2,2,82,41,41,164,82,82,164,82,82,0.5,5.0,1.0,4.0,12.0,4.0,8.0,12.0,4.0,8.0,2009
427,Mike Brown,CLE,5,5,82,61,21,410,272,138,410,272,138,0.6629999999999999,11.0,6.0,5.0,71.0,42.0,29.0,71.0,42.0,29.0,2009
428,Rick Carlisle,DAL,2,8,82,55,27,164,105,59,656,386,270,0.588,6.0,2.0,4.0,16.0,7.0,9.0,78.0,37.0,41.0,2009
429,George Karl,DEN,6,22,82,53,29,450,278,172,1657,986,671,0.595,6.0,2.0,4.0,41.0,15.0,26.0,167.0,74.0,93.0,2009
430,John Kuester,DET,1,1,82,27,55,82,27,55,82,27,55,0.32899999999999996,,,,,,,,,,2009
431,Don Nelson,GSW,11,31,82,26,56,865,422,443,2398,1335,1063,0.557,,,,35.0,14.0,21.0,166.0,75.0,91.0,2009
432,Rick Adelman,HOU,3,19,82,42,40,246,150,96,1479,902,577,0.61,,,,19.0,9.0,10.0,157.0,79.0,78.0,2009
433,Jim O'Brien,IND,3,8,82,32,50,246,104,142,586,286,300,0.488,,,,,,,31.0,14.0,17.0,2009
434,Mike Dunleavy,LAC,7,17,49,21,28,541,215,326,1329,613,716,0.461,,,,12.0,7.0,5.0,71.0,38.0,33.0,2009
435,Kim Hughes,LAC,1,1,33,8,25,33,8,25,33,8,25,0.242,,,,,,,,,,2009
436,Phil Jackson,LAL,10,19,82,57,25,820,553,267,1558,1098,460,0.705,23.0,16.0,7.0,171.0,114.0,57.0,323.0,225.0,98.0,2009
437,Lionel Hollins,MEM,4,4,82,40,42,185,71,114,185,71,114,0.384,,,,,,,,,,2009
438,Erik Spoelstra,MIA,2,2,82,47,35,164,90,74,164,90,74,0.5489999999999999,5.0,1.0,4.0,12.0,4.0,8.0,12.0,4.0,8.0,2009
439,Scott Skiles,MIL,2,10,82,46,36,164,80,84,696,361,335,0.519,7.0,3.0,4.0,7.0,3.0,4.0,42.0,18.0,24.0,2009
440,Kurt Rambis,MIN,1,2,82,15,67,82,15,67,119,39,80,0.32799999999999996,,,,,,,8.0,3.0,5.0,2009
441,Lawrence Frank,NJN,7,7,16,0,16,466,225,241,466,225,241,0.483,,,,38.0,18.0,20.0,38.0,18.0,20.0,2009
442,Tom Barrise,NJN,1,1,2,0,2,2,0,2,2,0,2,0.0,,,,,,,,,,2009
443,Kiki Vandeweghe,NJN,1,1,64,12,52,64,12,52,64,12,52,0.188,,,,,,,,,,2009
444,Byron Scott,NOH,6,10,9,3,6,419,203,216,707,352,355,0.498,,,,17.0,8.0,9.0,57.0,33.0,24.0,2009
445,Jeff Bower,NOH,1,1,73,34,39,73,34,39,73,34,39,0.466,,,,,,,,,,2009
446,Mike D'Antoni,NYK,2,8,82,29,53,164,61,103,603,328,275,0.544,,,,,,,51.0,26.0,25.0,2009
447,Scott Brooks,OKC,2,2,82,50,32,151,72,79,151,72,79,0.47700000000000004,6.0,2.0,4.0,6.0,2.0,4.0,6.0,2.0,4.0,2009
448,Stan Van Gundy,ORL,3,6,82,59,23,246,170,76,431,282,149,0.654,14.0,10.0,4.0,48.0,28.0,20.0,76.0,45.0,31.0,2009
449,Eddie Jordan,PHI,1,9,82,27,55,82,27,55,600,257,343,0.428,,,,,,,26.0,8.0,18.0,2009
450,Alvin Gentry,PHO,2,9,82,54,28,113,72,41,516,249,267,0.483,16.0,10.0,6.0,16.0,10.0,6.0,21.0,12.0,9.0,2009
451,Nate McMillan,POR,5,10,82,50,32,410,198,212,805,410,395,0.509,6.0,2.0,4.0,12.0,4.0,8.0,28.0,12.0,16.0,2009
452,Paul Westphal,SAC,1,8,82,25,57,82,25,57,508,292,216,0.575,,,,,,,49.0,27.0,22.0,2009
453,Gregg Popovich,SAS,14,14,82,50,32,1098,736,362,1098,736,362,0.67,10.0,4.0,6.0,175.0,106.0,69.0,175.0,106.0,69.0,2009
454,Jay Triano,TOR,2,2,82,40,42,147,65,82,147,65,82,0.442,,,,,,,,,,2009
455,Jerry Sloan,UTA,22,25,82,53,29,1755,1096,659,1970,1190,780,0.604,10.0,4.0,6.0,196.0,96.0,100.0,202.0,98.0,104.0,2009
456,Flip Saunders,WAS,1,14,82,26,56,82,26,56,1065,613,452,0.5760000000000001,,,,,,,98.0,47.0,51.0,2009
457,Hubie Brown,ATL,3,5,82,46,36,246,118,128,414,222,192,0.536,9.0,5.0,4.0,11.0,5.0,6.0,36.0,22.0,14.0,1978
458,Tom Sanders,BOS,2,2,14,2,12,62,23,39,62,23,39,0.371,,,,,,,,,,1978
459,Dave Cowens,BOS,1,1,68,27,41,68,27,41,68,27,41,0.397,,,,,,,,,,1978
460,Larry Costello,CHI,1,10,56,20,36,56,20,36,730,430,300,0.589,,,,,,,60.0,37.0,23.0,1978
461,Scotty Robertson,CHI,1,2,26,11,15,26,11,15,41,12,29,0.293,,,,,,,,,,1978
462,Bill Fitch,CLE,9,9,82,30,52,738,304,434,738,304,434,0.41200000000000003,,,,18.0,7.0,11.0,18.0,7.0,11.0,1978
463,Larry Brown,DEN,5,7,53,28,25,385,251,134,553,355,198,0.642,,,,45.0,21.0,24.0,61.0,28.0,33.0,1978
464,Donnie Walsh,DEN,1,1,29,19,10,29,19,10,29,19,10,0.655,3.0,1.0,2.0,3.0,1.0,2.0,3.0,1.0,2.0,1978
465,Dick Vitale,DET,1,1,82,30,52,82,30,52,82,30,52,0.366,,,,,,,,,,1978
466,Al Attles,GSW,10,10,82,38,44,768,425,343,768,425,343,0.5529999999999999,,,,61.0,31.0,30.0,61.0,31.0,30.0,1978
467,Tom Nissalke,HOU,3,8,82,47,35,246,124,122,531,260,271,0.49,2.0,0.0,2.0,14.0,6.0,8.0,31.0,11.0,20.0,1978
468,Slick Leonard,IND,11,13,82,38,44,903,492,411,1025,536,489,0.523,,,,116.0,69.0,47.0,116.0,69.0,47.0,1978
469,Cotton Fitzsimmons,KCK,1,8,82,48,34,82,48,34,648,312,336,0.48100000000000004,5.0,1.0,4.0,5.0,1.0,4.0,11.0,3.0,8.0,1978
470,Jerry West,LAL,3,3,82,47,35,246,145,101,246,145,101,0.589,8.0,3.0,5.0,22.0,8.0,14.0,22.0,8.0,14.0,1978
471,Don Nelson,MIL,3,3,82,38,44,228,109,119,228,109,119,0.478,,,,9.0,5.0,4.0,9.0,5.0,4.0,1978
472,Kevin Loughery,NJN,6,7,82,37,45,498,251,247,529,256,273,0.484,2.0,0.0,2.0,34.0,21.0,13.0,34.0,21.0,13.0,1978
473,Elgin Baylor,NOJ,4,4,82,26,56,221,86,135,221,86,135,0.389,,,,,,,,,,1978
474,Willis Reed,NYK,2,2,14,6,8,96,49,47,96,49,47,0.51,,,,6.0,2.0,4.0,6.0,2.0,4.0,1978
475,Red Holzman,NYK,11,15,68,25,43,850,491,359,1053,574,479,0.545,,,,95.0,54.0,41.0,103.0,58.0,45.0,1978
476,Billy Cunningham,PHI,2,2,82,47,35,158,100,58,158,100,58,0.633,9.0,5.0,4.0,19.0,11.0,8.0,19.0,11.0,8.0,1978
477,John MacLeod,PHO,6,6,82,50,32,492,237,255,492,237,255,0.48200000000000004,15.0,9.0,6.0,36.0,19.0,17.0,36.0,19.0,17.0,1978
478,Jack Ramsay,POR,3,11,82,45,37,246,152,94,902,484,418,0.537,3.0,1.0,2.0,28.0,17.0,11.0,67.0,31.0,36.0,1978
479,Doug Moe,SAS,3,3,82,48,34,246,144,102,246,144,102,0.585,14.0,7.0,7.0,22.0,9.0,13.0,22.0,9.0,13.0,1978
480,Gene Shue,SDC,1,13,82,43,39,82,43,39,964,491,473,0.509,,,,,,,62.0,25.0,37.0,1978
481,Lenny Wilkens,SEA,5,7,82,52,30,388,215,173,552,290,262,0.525,17.0,12.0,5.0,39.0,25.0,14.0,39.0,25.0,14.0,1978
482,Dick Motta,WSB,3,11,82,54,28,246,146,100,902,502,400,0.557,19.0,9.0,10.0,49.0,27.0,22.0,96.0,45.0,51.0,1978
483,Mike Fratello,ATL,3,3,82,34,48,167,74,93,167,74,93,0.44299999999999995,,,,5.0,2.0,3.0,5.0,2.0,3.0,1984
484,K.C. Jones,BOS,2,6,82,63,19,164,125,39,494,310,184,0.628,21.0,13.0,8.0,44.0,28.0,16.0,79.0,42.0,37.0,1984
485,Kevin Loughery,CHI,2,13,82,38,44,164,65,99,974,452,522,0.46399999999999997,4.0,1.0,3.0,4.0,1.0,3.0,43.0,23.0,20.0,1984
486,George Karl,CLE,1,1,82,36,46,82,36,46,82,36,46,0.439,4.0,1.0,3.0,4.0,1.0,3.0,4.0,1.0,3.0,1984
487,Dick Motta,DAL,5,17,82,44,38,410,168,242,1394,709,685,0.509,4.0,1.0,3.0,14.0,5.0,9.0,112.0,50.0,62.0,1984
488,Doug Moe,DEN,5,9,82,52,30,379,207,172,691,384,307,0.556,15.0,8.0,7.0,31.0,14.0,17.0,53.0,23.0,30.0,1984
489,Chuck Daly,DET,2,3,82,46,36,164,95,69,205,104,101,0.507,9.0,5.0,4.0,14.0,7.0,7.0,14.0,7.0,7.0,1984
490,Johnny Bach,GSW,3,3,82,22,60,185,65,120,185,65,120,0.35100000000000003,,,,,,,,,,1984
491,Bill Fitch,HOU,2,15,82,48,34,164,77,87,1230,623,607,0.507,5.0,2.0,3.0,5.0,2.0,3.0,68.0,35.0,33.0,1984
492,George Irvine,IND,1,1,82,22,60,82,22,60,82,22,60,0.268,,,,,,,,,,1984
493,Jack McKinney,KCK,1,6,9,1,8,9,1,8,351,136,215,0.387,,,,,,,2.0,0.0,2.0,1984
494,Phil Johnson,KCK,6,7,73,30,43,414,185,229,415,185,230,0.446,,,,6.0,2.0,4.0,6.0,2.0,4.0,1984
495,Jim Lynam,LAC,2,2,61,22,39,143,52,91,143,52,91,0.364,,,,,,,,,,1984
496,Don Chaney,LAC,1,1,21,9,12,21,9,12,21,9,12,0.429,,,,,,,,,,1984
497,Pat Riley,LAL,4,4,82,62,20,317,224,93,317,224,93,0.7070000000000001,19.0,15.0,4.0,69.0,49.0,20.0,69.0,49.0,20.0,1984
498,Don Nelson,MIL,9,9,82,59,23,720,433,287,720,433,287,0.601,8.0,3.0,5.0,62.0,29.0,33.0,62.0,29.0,33.0,1984
499,Stan Albeck,NJN,2,7,82,42,40,164,87,77,563,304,259,0.54,3.0,0.0,3.0,14.0,5.0,9.0,41.0,18.0,23.0,1984
500,Hubie Brown,NYK,3,10,82,24,58,246,115,131,821,418,403,0.509,,,,18.0,8.0,10.0,59.0,31.0,28.0,1984
501,Billy Cunningham,PHI,8,8,82,58,24,650,454,196,650,454,196,0.698,13.0,8.0,5.0,105.0,66.0,39.0,105.0,66.0,39.0,1984
502,John MacLeod,PHO,12,12,82,36,46,984,525,459,984,525,459,0.534,3.0,0.0,3.0,81.0,37.0,44.0,81.0,37.0,44.0,1984
503,Jack Ramsay,POR,9,17,82,42,40,738,413,325,1394,745,649,0.534,9.0,4.0,5.0,55.0,28.0,27.0,94.0,42.0,52.0,1984
504,Cotton Fitzsimmons,SAS,1,14,82,41,41,82,41,41,1140,553,587,0.485,5.0,2.0,3.0,5.0,2.0,3.0,37.0,13.0,24.0,1984
505,Lenny Wilkens,SEA,11,13,82,31,51,880,478,402,1044,553,491,0.53,,,,69.0,37.0,32.0,69.0,37.0,32.0,1984
506,Frank Layden,UTA,4,4,82,41,41,308,133,175,308,133,175,0.43200000000000005,10.0,4.0,6.0,21.0,9.0,12.0,21.0,9.0,12.0,1984
507,Gene Shue,WSB,12,19,82,40,42,958,490,468,1456,725,731,0.498,4.0,1.0,3.0,55.0,19.0,36.0,77.0,30.0,47.0,1984
508,Mike Budenholzer,ATL,2,2,82,60,22,164,98,66,164,98,66,0.598,16.0,8.0,8.0,23.0,11.0,12.0,23.0,11.0,12.0,2014
509,Brad Stevens,BOS,2,2,82,40,42,164,65,99,164,65,99,0.396,4.0,0.0,4.0,4.0,0.0,4.0,4.0,0.0,4.0,2014
510,Lionel Hollins,BRK,1,8,82,38,44,82,38,44,497,252,245,0.507,6.0,2.0,4.0,6.0,2.0,4.0,41.0,20.0,21.0,2014
511,Tom Thibodeau,CHI,5,5,82,50,32,394,255,139,394,255,139,0.647,12.0,6.0,6.0,51.0,23.0,28.0,51.0,23.0,28.0,2014
512,Steve Clifford,CHO,2,2,82,33,49,164,76,88,164,76,88,0.46299999999999997,,,,4.0,0.0,4.0,4.0,0.0,4.0,2014
513,David Blatt,CLE,1,1,82,53,29,82,53,29,82,53,29,0.6459999999999999,20.0,14.0,6.0,20.0,14.0,6.0,20.0,14.0,6.0,2014
514,Rick Carlisle,DAL,7,13,82,50,32,558,338,220,1050,619,431,0.59,5.0,1.0,4.0,53.0,27.0,26.0,115.0,57.0,58.0,2014
515,Brian Shaw,DEN,2,2,59,20,39,141,56,85,141,56,85,0.397,,,,,,,,,,2014
516,Melvin Hunt,DEN,1,1,23,10,13,23,10,13,23,10,13,0.435,,,,,,,,,,2014
517,Stan Van Gundy,DET,1,9,82,32,50,82,32,50,661,403,258,0.61,,,,,,,87.0,48.0,39.0,2014
518,Steve Kerr,GSW,1,1,82,67,15,82,67,15,82,67,15,0.8170000000000001,21.0,16.0,5.0,21.0,16.0,5.0,21.0,16.0,5.0,2014
519,Kevin McHale,HOU,4,6,82,56,26,312,189,123,406,228,178,0.562,17.0,9.0,8.0,29.0,13.0,16.0,29.0,13.0,16.0,2014
520,Frank Vogel,IND,5,5,82,38,44,349,205,144,349,205,144,0.5870000000000001,,,,54.0,28.0,26.0,54.0,28.0,26.0,2014
521,Doc Rivers,LAC,2,16,82,56,26,164,113,51,1224,700,524,0.5720000000000001,14.0,7.0,7.0,27.0,13.0,14.0,148.0,77.0,71.0,2014
522,Byron Scott,LAL,1,14,82,21,61,82,21,61,1019,437,582,0.429,,,,,,,57.0,33.0,24.0,2014
523,Dave Joerger,MEM,2,2,82,55,27,164,105,59,164,105,59,0.64,11.0,6.0,5.0,18.0,9.0,9.0,18.0,9.0,9.0,2014
524,Erik Spoelstra,MIA,7,7,82,37,45,558,351,207,558,351,207,0.629,,,,99.0,63.0,36.0,99.0,63.0,36.0,2014
525,Jason Kidd,MIL,1,2,82,41,41,82,41,41,164,85,79,0.518,6.0,2.0,4.0,6.0,2.0,4.0,18.0,7.0,11.0,2014
526,Flip Saunders,MIN,11,17,82,16,66,819,427,392,1246,654,592,0.525,,,,47.0,17.0,30.0,98.0,47.0,51.0,2014
527,Monty Williams,NOP,5,5,82,45,37,394,173,221,394,173,221,0.439,4.0,0.0,4.0,10.0,2.0,8.0,10.0,2.0,8.0,2014
528,Derek Fisher,NYK,1,1,82,17,65,82,17,65,82,17,65,0.207,,,,,,,,,,2014
529,Scott Brooks,OKC,7,7,82,45,37,545,338,207,545,338,207,0.62,,,,73.0,39.0,34.0,73.0,39.0,34.0,2014
530,Jacque Vaughn,ORL,3,3,52,15,37,216,58,158,216,58,158,0.26899999999999996,,,,,,,,,,2014
531,James Borrego,ORL,1,1,30,10,20,30,10,20,30,10,20,0.33299999999999996,,,,,,,,,,2014
532,Brett Brown,PHI,2,2,82,18,64,164,37,127,164,37,127,0.226,,,,,,,,,,2014
533,Jeff Hornacek,PHO,2,2,82,39,43,164,87,77,164,87,77,0.53,,,,,,,,,,2014
534,Terry Stotts,POR,3,7,82,51,31,246,138,108,529,253,276,0.478,5.0,1.0,4.0,16.0,6.0,10.0,21.0,7.0,14.0,2014
535,Mike Malone,SAC,2,2,24,11,13,106,39,67,106,39,67,0.368,,,,,,,,,,2014
536,Tyrone Corbin,SAC,1,5,28,7,21,28,7,21,286,119,167,0.41600000000000004,,,,,,,4.0,0.0,4.0,2014
537,George Karl,SAC,1,26,30,11,19,30,11,19,1917,1142,775,0.596,,,,,,,185.0,80.0,105.0,2014
538,Gregg Popovich,SAS,19,19,82,55,27,1492,1022,470,1492,1022,470,0.685,7.0,3.0,4.0,246.0,152.0,94.0,246.0,152.0,94.0,2014
539,Dwane Casey,TOR,4,6,82,49,33,312,154,158,434,207,227,0.47700000000000004,4.0,0.0,4.0,11.0,3.0,8.0,11.0,3.0,8.0,2014
540,Quin Snyder,UTA,1,1,82,38,44,82,38,44,82,38,44,0.46299999999999997,,,,,,,,,,2014
541,Randy Wittman,WAS,4,9,82,46,36,295,137,158,602,237,365,0.39399999999999996,10.0,6.0,4.0,21.0,12.0,9.0,21.0,12.0,9.0,2014
542,Mike Woodson,ATL,2,2,82,26,56,164,39,125,164,39,125,0.23800000000000002,,,,,,,,,,2005
543,Doc Rivers,BOS,2,7,82,33,49,164,78,86,503,249,254,0.495,,,,7.0,3.0,4.0,22.0,8.0,14.0,2005
544,Bernie Bickerstaff,CHA,2,12,82,26,56,164,44,120,850,382,468,0.449,,,,,,,33.0,12.0,21.0,2005
545,Scott Skiles,CHI,3,6,82,41,41,230,107,123,425,223,202,0.525,6.0,2.0,4.0,12.0,4.0,8.0,25.0,9.0,16.0,2005
546,Mike Brown,CLE,1,1,82,50,32,82,50,32,82,50,32,0.61,13.0,7.0,6.0,13.0,7.0,6.0,13.0,7.0,6.0,2005
547,Avery Johnson,DAL,2,2,82,60,22,100,76,24,100,76,24,0.76,23.0,14.0,9.0,36.0,20.0,16.0,36.0,20.0,16.0,2005
548,George Karl,DEN,2,18,82,44,38,122,76,46,1329,784,545,0.59,5.0,1.0,4.0,10.0,2.0,8.0,136.0,61.0,75.0,2005
549,Flip Saunders,DET,1,11,82,64,18,82,64,18,819,475,344,0.58,18.0,10.0,8.0,18.0,10.0,8.0,65.0,27.0,38.0,2005
550,Mike Montgomery,GSW,2,2,82,34,48,164,68,96,164,68,96,0.415,,,,,,,,,,2005
551,Jeff Van Gundy,HOU,3,10,82,34,48,246,130,116,666,378,288,0.568,,,,12.0,4.0,8.0,81.0,41.0,40.0,2005
552,Rick Carlisle,IND,3,5,82,41,41,246,146,100,410,246,164,0.6,6.0,2.0,4.0,35.0,18.0,17.0,62.0,30.0,32.0,2005
553,Mike Dunleavy,LAC,3,13,82,47,35,246,112,134,1034,510,524,0.493,12.0,7.0,5.0,12.0,7.0,5.0,71.0,38.0,33.0,2005
554,Phil Jackson,LAL,6,15,82,45,37,492,332,160,1230,877,353,0.713,7.0,3.0,4.0,99.0,67.0,32.0,251.0,178.0,73.0,2005
555,Mike Fratello,MEM,2,16,82,49,33,148,89,59,1185,661,524,0.5579999999999999,4.0,0.0,4.0,8.0,0.0,8.0,62.0,20.0,42.0,2005
556,Stan Van Gundy,MIA,3,3,21,11,10,185,112,73,185,112,73,0.605,,,,28.0,17.0,11.0,28.0,17.0,11.0,2005
557,Pat Riley,MIA,9,22,61,41,20,685,395,290,1740,1151,589,0.6609999999999999,23.0,16.0,7.0,66.0,34.0,32.0,278.0,171.0,107.0,2005
558,Terry Stotts,MIL,1,3,82,40,42,82,40,42,219,92,127,0.42,5.0,1.0,4.0,5.0,1.0,4.0,5.0,1.0,4.0,2005
559,Dwane Casey,MIN,1,1,82,33,49,82,33,49,82,33,49,0.402,,,,,,,,,,2005
560,Lawrence Frank,NJN,3,3,82,49,33,204,116,88,204,116,88,0.569,11.0,5.0,6.0,26.0,12.0,14.0,26.0,12.0,14.0,2005
561,Byron Scott,NOK,2,6,82,38,44,164,56,108,452,205,247,0.45399999999999996,,,,,,,40.0,25.0,15.0,2005
562,Larry Brown,NYK,1,27,82,23,59,82,23,59,2146,1239,907,0.5770000000000001,,,,,,,231.0,120.0,111.0,2005
563,Brian Hill,ORL,5,8,82,36,46,377,227,150,531,258,273,0.486,,,,36.0,18.0,18.0,36.0,18.0,18.0,2005
564,Maurice Cheeks,PHI,1,5,82,38,44,82,38,44,383,200,183,0.522,,,,,,,10.0,3.0,7.0,2005
565,Mike D'Antoni,PHO,3,4,82,54,28,225,137,88,275,151,124,0.5489999999999999,20.0,10.0,10.0,35.0,19.0,16.0,35.0,19.0,16.0,2005
566,Nate McMillan,POR,1,6,82,21,61,82,21,61,477,233,244,0.488,,,,,,,16.0,8.0,8.0,2005
567,Rick Adelman,SAC,8,16,82,44,38,624,395,229,1233,752,481,0.61,6.0,2.0,4.0,69.0,34.0,35.0,138.0,70.0,68.0,2005
568,Gregg Popovich,SAS,10,10,82,63,19,770,518,252,770,518,252,0.6729999999999999,13.0,7.0,6.0,123.0,76.0,47.0,123.0,76.0,47.0,2005
569,Bob Weiss,SEA,1,7,30,13,17,30,13,17,522,223,299,0.42700000000000005,,,,,,,11.0,2.0,9.0,2005
570,Bob Hill,SEA,1,8,52,22,30,52,22,30,521,279,242,0.536,,,,,,,37.0,17.0,20.0,2005
571,Sam Mitchell,TOR,2,2,82,27,55,164,60,104,164,60,104,0.366,,,,,,,,,,2005
572,Jerry Sloan,UTA,18,21,82,41,41,1427,890,537,1642,984,658,0.599,,,,152.0,76.0,76.0,158.0,78.0,80.0,2005
573,Eddie Jordan,WAS,3,5,82,42,40,246,112,134,343,145,198,0.423,6.0,2.0,4.0,16.0,6.0,10.0,16.0,6.0,10.0,2005
574,Kevin Loughery,ATL,2,11,82,43,39,164,85,79,810,387,423,0.478,3.0,1.0,2.0,5.0,1.0,4.0,39.0,22.0,17.0,1982
575,Bill Fitch,BOS,4,13,82,56,26,328,242,86,1066,546,520,0.512,7.0,2.0,5.0,45.0,26.0,19.0,63.0,33.0,30.0,1982
576,Paul Westhead,CHI,1,4,82,28,54,82,28,54,243,139,104,0.5720000000000001,,,,,,,19.0,13.0,6.0,1982
577,Tom Nissalke,CLE,1,12,82,23,59,82,23,59,797,343,454,0.43,,,,,,,31.0,11.0,20.0,1982
578,Dick Motta,DAL,3,15,82,38,44,246,81,165,1230,622,608,0.506,,,,,,,98.0,45.0,53.0,1982
579,Doug Moe,DEN,3,7,82,45,37,215,117,98,527,294,233,0.5579999999999999,8.0,3.0,5.0,11.0,4.0,7.0,33.0,13.0,20.0,1982
580,Scotty Robertson,DET,3,5,82,37,45,246,97,149,287,109,178,0.38,,,,,,,,,,1982
581,Al Attles,GSW,14,14,82,30,52,1075,557,518,1075,557,518,0.518,,,,61.0,31.0,30.0,61.0,31.0,30.0,1982
582,Del Harris,HOU,4,4,82,14,68,328,141,187,328,141,187,0.43,,,,31.0,15.0,16.0,31.0,15.0,16.0,1982
583,Jack McKinney,IND,3,4,82,20,62,246,99,147,260,109,151,0.419,,,,2.0,0.0,2.0,2.0,0.0,2.0,1982
584,Cotton Fitzsimmons,KCK,5,12,82,45,37,410,210,200,976,474,502,0.486,,,,23.0,9.0,14.0,29.0,11.0,18.0,1982
585,Pat Riley,LAL,2,2,82,58,24,153,108,45,153,108,45,0.706,15.0,8.0,7.0,29.0,20.0,9.0,29.0,20.0,9.0,1982
586,Don Nelson,MIL,7,7,82,51,31,556,324,232,556,324,232,0.583,9.0,5.0,4.0,38.0,18.0,20.0,38.0,18.0,20.0,1982
587,Larry Brown,NJN,2,9,76,47,29,158,91,67,711,446,265,0.627,,,,2.0,0.0,2.0,63.0,28.0,35.0,1982
588,Bill Blair,NJN,1,1,6,2,4,6,2,4,6,2,4,0.33299999999999996,2.0,0.0,2.0,2.0,0.0,2.0,2.0,0.0,2.0,1982
589,Hubie Brown,NYK,1,8,82,44,38,82,44,38,657,347,310,0.528,6.0,2.0,4.0,6.0,2.0,4.0,47.0,25.0,22.0,1982
590,Billy Cunningham,PHI,6,6,82,65,17,486,344,142,486,344,142,0.708,13.0,12.0,1.0,87.0,56.0,31.0,87.0,56.0,31.0,1982
591,John MacLeod,PHO,10,10,82,53,29,820,448,372,820,448,372,0.546,3.0,1.0,2.0,61.0,28.0,33.0,61.0,28.0,33.0,1982
592,Jack Ramsay,POR,7,15,82,46,36,574,323,251,1230,655,575,0.5329999999999999,7.0,3.0,4.0,41.0,22.0,19.0,80.0,36.0,44.0,1982
593,Stan Albeck,SAS,3,5,82,53,29,246,153,93,399,217,182,0.544,11.0,6.0,5.0,27.0,13.0,14.0,27.0,13.0,14.0,1982
594,Paul Silas,SDC,3,3,82,25,57,246,78,168,246,78,168,0.317,,,,,,,,,,1982
595,Lenny Wilkens,SEA,9,11,82,48,34,716,405,311,880,480,400,0.545,2.0,0.0,2.0,64.0,35.0,29.0,64.0,35.0,29.0,1982
596,Frank Layden,UTA,2,2,82,30,52,144,47,97,144,47,97,0.326,,,,,,,,,,1982
597,Gene Shue,WSB,10,17,82,42,40,794,415,379,1292,650,642,0.503,,,,47.0,17.0,30.0,69.0,28.0,41.0,1982
598,Cotton Fitzsimmons,ATL,1,3,82,46,36,82,46,36,246,143,103,0.581,6.0,2.0,4.0,6.0,2.0,4.0,6.0,2.0,4.0,1972
599,Gene Shue,BAL,7,7,82,52,30,548,291,257,548,291,257,0.531,5.0,1.0,4.0,40.0,14.0,26.0,40.0,14.0,26.0,1972
600,Tom Heinsohn,BOS,4,4,82,68,14,328,202,126,328,202,126,0.616,13.0,7.0,6.0,24.0,12.0,12.0,24.0,12.0,12.0,1972
601,Jack Ramsay,BUF,1,5,82,21,61,82,21,61,410,195,215,0.47600000000000003,,,,,,,17.0,5.0,12.0,1972
602,Dick Motta,CHI,5,5,82,51,31,410,231,179,410,231,179,0.563,7.0,3.0,4.0,23.0,7.0,16.0,23.0,7.0,16.0,1972
603,Bill Fitch,CLE,3,3,82,32,50,246,70,176,246,70,176,0.285,,,,,,,,,,1972
604,Earl Lloyd,DET,2,2,7,2,5,77,22,55,77,22,55,0.28600000000000003,,,,,,,,,,1972
605,Ray Scott,DET,1,1,75,38,37,75,38,37,75,38,37,0.507,,,,,,,,,,1972
606,Al Attles,GSW,4,4,82,47,35,276,147,129,276,147,129,0.5329999999999999,11.0,5.0,6.0,21.0,7.0,14.0,21.0,7.0,14.0,1972
607,Tex Winter,HOU,2,2,47,17,30,129,51,78,129,51,78,0.395,,,,,,,,,,1972
608,Johnny Egan,HOU,1,1,35,16,19,35,16,19,35,16,19,0.457,,,,,,,,,,1972
609,Bob Cousy,KCO,4,4,82,36,46,328,135,193,328,135,193,0.41200000000000003,,,,,,,,,,1972
610,Bill Sharman,LAL,2,7,82,60,22,164,129,35,573,349,224,0.609,17.0,9.0,8.0,32.0,21.0,11.0,92.0,56.0,36.0,1972
611,Larry Costello,MIL,5,5,82,60,22,410,272,138,410,272,138,0.6629999999999999,6.0,2.0,4.0,41.0,25.0,16.0,41.0,25.0,16.0,1972
612,Red Holzman,NYK,6,10,82,57,25,454,299,155,657,382,275,0.581,17.0,12.0,5.0,80.0,48.0,32.0,88.0,52.0,36.0,1972
613,Roy Rubin,PHI,1,1,51,4,47,51,4,47,51,4,47,0.078,,,,,,,,,,1972
614,Kevin Loughery,PHI,1,1,31,5,26,31,5,26,31,5,26,0.161,,,,,,,,,,1972
615,Butch van Breda Kolff,PHO,1,6,7,3,4,7,3,4,345,192,153,0.557,,,,,,,33.0,21.0,12.0,1972
616,Jerry Colangelo,PHO,2,2,75,35,40,119,59,60,119,59,60,0.496,,,,7.0,3.0,4.0,7.0,3.0,4.0,1972
617,Jack McCloskey,POR,1,1,82,21,61,82,21,61,82,21,61,0.256,,,,,,,,,,1972
618,Tom Nissalke,SEA,1,2,45,13,32,45,13,32,129,55,74,0.426,,,,,,,4.0,0.0,4.0,1972
619,Bucky Buckwalter,SEA,1,1,37,13,24,37,13,24,37,13,24,0.35100000000000003,,,,,,,,,,1972
620,Mike Woodson,ATL,4,4,82,37,45,328,106,222,328,106,222,0.32299999999999995,7.0,3.0,4.0,7.0,3.0,4.0,7.0,3.0,4.0,2007
621,Doc Rivers,BOS,4,9,82,66,16,328,168,160,667,339,328,0.508,26.0,16.0,10.0,33.0,19.0,14.0,48.0,24.0,24.0,2007
622,Sam Vincent,CHA,1,1,82,32,50,82,32,50,82,32,50,0.39,,,,,,,,,,2007
623,Scott Skiles,CHI,5,8,25,9,16,337,165,172,532,281,251,0.528,,,,22.0,10.0,12.0,35.0,15.0,20.0,2007
624,Pete Myers,CHI,2,2,1,0,1,3,0,3,3,0,3,0.0,,,,,,,,,,2007
625,Jim Boylan,CHI,1,1,56,24,32,56,24,32,56,24,32,0.429,,,,,,,,,,2007
626,Mike Brown,CLE,3,3,82,45,37,246,145,101,246,145,101,0.589,13.0,7.0,6.0,46.0,26.0,20.0,46.0,26.0,20.0,2007
627,Avery Johnson,DAL,4,4,82,51,31,264,194,70,264,194,70,0.735,5.0,1.0,4.0,47.0,23.0,24.0,47.0,23.0,24.0,2007
628,George Karl,DEN,4,20,82,50,32,286,171,115,1493,879,614,0.589,4.0,0.0,4.0,19.0,3.0,16.0,145.0,62.0,83.0,2007
629,Flip Saunders,DET,3,13,82,59,23,246,176,70,983,587,396,0.597,17.0,10.0,7.0,51.0,30.0,21.0,98.0,47.0,51.0,2007
630,Don Nelson,GSW,9,29,82,48,34,701,367,334,2234,1280,954,0.573,,,,35.0,14.0,21.0,166.0,75.0,91.0,2007
631,Rick Adelman,HOU,1,17,82,55,27,82,55,27,1315,807,508,0.614,6.0,2.0,4.0,6.0,2.0,4.0,144.0,72.0,72.0,2007
632,Jim O'Brien,IND,1,6,82,36,46,82,36,46,422,218,204,0.517,,,,,,,31.0,14.0,17.0,2007
633,Mike Dunleavy,LAC,5,15,82,23,59,410,175,235,1198,573,625,0.478,,,,12.0,7.0,5.0,71.0,38.0,33.0,2007
634,Phil Jackson,LAL,8,17,82,57,25,656,431,225,1394,976,418,0.7,21.0,14.0,7.0,125.0,82.0,43.0,277.0,193.0,84.0,2007
635,Marc Iavaroni,MEM,1,1,82,22,60,82,22,60,82,22,60,0.268,,,,,,,,,,2007
636,Pat Riley,MIA,11,24,82,15,67,849,454,395,1904,1210,694,0.636,,,,70.0,34.0,36.0,282.0,171.0,111.0,2007
637,Larry Krystkowiak,MIL,2,2,82,26,56,100,31,69,100,31,69,0.31,,,,,,,,,,2007
638,Randy Wittman,MIN,2,4,82,22,60,124,34,90,288,96,192,0.33299999999999996,,,,,,,,,,2007
639,Lawrence Frank,NJN,5,5,82,34,48,368,191,177,368,191,177,0.519,,,,38.0,18.0,20.0,38.0,18.0,20.0,2007
640,Byron Scott,NOH,4,8,82,56,26,328,151,177,616,300,316,0.48700000000000004,12.0,7.0,5.0,12.0,7.0,5.0,52.0,32.0,20.0,2007
641,Isiah Thomas,NYK,2,5,82,23,59,164,56,108,410,187,223,0.456,,,,,,,15.0,5.0,10.0,2007
642,Stan Van Gundy,ORL,1,4,82,52,30,82,52,30,267,164,103,0.614,10.0,5.0,5.0,10.0,5.0,5.0,38.0,22.0,16.0,2007
643,Maurice Cheeks,PHI,3,7,82,40,42,246,113,133,547,275,272,0.503,6.0,2.0,4.0,6.0,2.0,4.0,16.0,5.0,11.0,2007
644,Mike D'Antoni,PHO,5,6,82,55,27,389,253,136,439,267,172,0.608,5.0,1.0,4.0,51.0,26.0,25.0,51.0,26.0,25.0,2007
645,Nate McMillan,POR,3,8,82,41,41,246,94,152,641,306,335,0.47700000000000004,,,,,,,16.0,8.0,8.0,2007
646,Reggie Theus,SAC,1,1,82,38,44,82,38,44,82,38,44,0.46299999999999997,,,,,,,,,,2007
647,Gregg Popovich,SAS,12,12,82,56,26,934,632,302,934,632,302,0.677,17.0,9.0,8.0,160.0,101.0,59.0,160.0,101.0,59.0,2007
648,P.J. Carlesimo,SEA,1,7,82,20,62,82,20,62,487,203,284,0.41700000000000004,,,,,,,12.0,3.0,9.0,2007
649,Sam Mitchell,TOR,4,4,82,41,41,328,148,180,328,148,180,0.451,5.0,1.0,4.0,11.0,3.0,8.0,11.0,3.0,8.0,2007
650,Jerry Sloan,UTA,20,23,82,54,28,1591,995,596,1806,1089,717,0.603,12.0,6.0,6.0,181.0,91.0,90.0,187.0,93.0,94.0,2007
651,Eddie Jordan,WAS,5,7,82,43,39,410,196,214,507,229,278,0.452,6.0,2.0,4.0,26.0,8.0,18.0,26.0,8.0,18.0,2007
652,Richie Guerin,ATL,6,6,82,48,34,454,255,199,454,255,199,0.562,9.0,4.0,5.0,49.0,23.0,26.0,49.0,23.0,26.0,1969
653,Gene Shue,BAL,4,4,82,50,32,302,159,143,302,159,143,0.526,7.0,3.0,4.0,11.0,3.0,8.0,11.0,3.0,8.0,1969
654,Tom Heinsohn,BOS,1,1,82,34,48,82,34,48,82,34,48,0.415,,,,,,,,,,1969
655,Dick Motta,CHI,2,2,82,39,43,164,72,92,164,72,92,0.439,5.0,1.0,4.0,5.0,1.0,4.0,5.0,1.0,4.0,1969
656,Bob Cousy,CIN,1,1,82,36,46,82,36,46,82,36,46,0.439,,,,,,,,,,1969
657,Butch van Breda Kolff,DET,1,3,82,31,51,82,31,51,246,138,108,0.561,,,,,,,33.0,21.0,12.0,1969
658,Joe Mullaney,LAL,1,1,82,46,36,82,46,36,82,46,36,0.561,18.0,11.0,7.0,18.0,11.0,7.0,18.0,11.0,7.0,1969
659,Larry Costello,MIL,2,2,82,56,26,164,83,81,164,83,81,0.506,10.0,5.0,5.0,10.0,5.0,5.0,10.0,5.0,5.0,1969
660,Red Holzman,NYK,3,7,82,60,22,208,142,66,411,225,186,0.547,19.0,12.0,7.0,35.0,20.0,15.0,43.0,24.0,19.0,1969
661,Jack Ramsay,PHI,2,2,82,42,40,164,97,67,164,97,67,0.591,5.0,1.0,4.0,10.0,2.0,8.0,10.0,2.0,8.0,1969
662,Red Kerr,PHO,2,4,38,15,23,120,31,89,283,93,190,0.32899999999999996,,,,,,,8.0,1.0,7.0,1969
663,Jerry Colangelo,PHO,1,1,44,24,20,44,24,20,44,24,20,0.545,7.0,3.0,4.0,7.0,3.0,4.0,7.0,3.0,4.0,1969
664,Jack McMahon,SDR,3,8,26,9,17,190,61,129,549,260,289,0.474,,,,6.0,2.0,4.0,29.0,10.0,19.0,1969
665,Alex Hannum,SDR,1,12,56,18,38,56,18,38,879,491,388,0.5589999999999999,,,,,,,95.0,57.0,38.0,1969
666,Lenny Wilkens,SEA,1,1,82,36,46,82,36,46,82,36,46,0.439,,,,,,,,,,1969
667,George Lee,SFW,2,2,52,22,30,134,63,71,134,63,71,0.47,,,,6.0,2.0,4.0,6.0,2.0,4.0,1969
668,Al Attles,SFW,1,1,30,8,22,30,8,22,30,8,22,0.267,,,,,,,,,,1969
669,Larry Drew,ATL,3,3,82,44,38,230,128,102,230,128,102,0.557,6.0,2.0,4.0,24.0,10.0,14.0,24.0,10.0,14.0,2012
670,Doc Rivers,BOS,9,14,81,41,40,721,416,305,1060,587,473,0.5539999999999999,6.0,2.0,4.0,106.0,59.0,47.0,121.0,64.0,57.0,2012
671,Avery Johnson,BRK,3,7,28,14,14,176,60,116,440,254,186,0.5770000000000001,,,,,,,47.0,23.0,24.0,2012
672,P.J. Carlesimo,BRK,1,9,54,35,19,54,35,19,554,239,315,0.431,7.0,3.0,4.0,7.0,3.0,4.0,19.0,6.0,13.0,2012
673,Mike Dunlap,CHA,1,1,82,21,61,82,21,61,82,21,61,0.256,,,,,,,,,,2012
674,Tom Thibodeau,CHI,3,3,82,45,37,230,157,73,230,157,73,0.6829999999999999,12.0,5.0,7.0,34.0,16.0,18.0,34.0,16.0,18.0,2012
675,Byron Scott,CLE,3,13,82,24,58,230,64,166,937,416,521,0.444,,,,,,,57.0,33.0,24.0,2012
676,Rick Carlisle,DAL,5,11,82,41,41,394,239,155,886,520,366,0.5870000000000001,,,,41.0,23.0,18.0,103.0,53.0,50.0,2012
677,George Karl,DEN,9,25,82,57,25,680,423,257,1887,1131,756,0.599,6.0,2.0,4.0,59.0,21.0,38.0,185.0,80.0,105.0,2012
678,Lawrence Frank,DET,2,9,82,29,53,148,54,94,614,279,335,0.45399999999999996,,,,,,,38.0,18.0,20.0,2012
679,Mark Jackson,GSW,2,2,82,47,35,148,70,78,148,70,78,0.473,12.0,6.0,6.0,12.0,6.0,6.0,12.0,6.0,6.0,2012
680,Kevin McHale,HOU,2,4,82,45,37,148,79,69,242,118,124,0.488,6.0,2.0,4.0,6.0,2.0,4.0,6.0,2.0,4.0,2012
681,Frank Vogel,IND,3,3,81,49,32,185,111,74,185,111,74,0.6,19.0,11.0,8.0,35.0,18.0,17.0,35.0,18.0,17.0,2012
682,Vinny Del Negro,LAC,3,5,82,56,26,230,128,102,394,210,184,0.5329999999999999,6.0,2.0,4.0,17.0,6.0,11.0,29.0,10.0,19.0,2012
683,Mike Brown,LAL,2,7,5,1,4,71,42,29,481,314,167,0.653,,,,12.0,5.0,7.0,83.0,47.0,36.0,2012
684,Bernie Bickerstaff,LAL,1,14,5,4,1,5,4,1,937,419,518,0.447,,,,,,,33.0,12.0,21.0,2012
685,Mike D'Antoni,LAL,1,11,72,40,32,72,40,32,799,428,371,0.536,4.0,0.0,4.0,4.0,0.0,4.0,59.0,26.0,33.0,2012
686,Lionel Hollins,MEM,7,7,82,56,26,415,214,201,415,214,201,0.516,15.0,8.0,7.0,35.0,18.0,17.0,35.0,18.0,17.0,2012
687,Erik Spoelstra,MIA,5,5,82,66,16,394,260,134,394,260,134,0.66,23.0,16.0,7.0,79.0,50.0,29.0,79.0,50.0,29.0,2012
688,Scott Skiles,MIL,5,13,32,16,16,344,162,182,876,443,433,0.506,,,,7.0,3.0,4.0,42.0,18.0,24.0,2012
689,Jim Boylan,MIL,1,2,50,22,28,50,22,28,106,46,60,0.434,4.0,0.0,4.0,4.0,0.0,4.0,4.0,0.0,4.0,2012
690,Rick Adelman,MIN,2,22,82,31,51,148,57,91,1709,1002,707,0.586,,,,,,,157.0,79.0,78.0,2012
691,Monty Williams,NOH,3,3,82,27,55,230,94,136,230,94,136,0.409,,,,6.0,2.0,4.0,6.0,2.0,4.0,2012
692,Mike Woodson,NYK,2,8,82,54,28,106,72,34,598,278,320,0.465,12.0,6.0,6.0,17.0,7.0,10.0,46.0,18.0,28.0,2012
693,Scott Brooks,OKC,5,5,82,60,22,381,234,147,381,234,147,0.614,11.0,5.0,6.0,54.0,29.0,25.0,54.0,29.0,25.0,2012
694,Jacque Vaughn,ORL,1,1,82,20,62,82,20,62,82,20,62,0.244,,,,,,,,,,2012
695,Doug Collins,PHI,3,11,82,34,48,230,110,120,849,442,407,0.521,,,,18.0,8.0,10.0,56.0,23.0,33.0,2012
696,Alvin Gentry,PHO,5,12,41,13,28,302,158,144,705,335,370,0.475,,,,16.0,10.0,6.0,21.0,12.0,9.0,2012
697,Lindsey Hunter,PHO,1,1,41,12,29,41,12,29,41,12,29,0.293,,,,,,,,,,2012
698,Terry Stotts,POR,1,5,82,33,49,82,33,49,365,148,217,0.405,,,,,,,5.0,1.0,4.0,2012
699,Keith Smart,SAC,2,4,82,28,54,141,48,93,263,93,170,0.354,,,,,,,,,,2012
700,Gregg Popovich,SAS,17,17,82,58,24,1328,905,423,1328,905,423,0.6809999999999999,21.0,15.0,6.0,216.0,133.0,83.0,216.0,133.0,83.0,2012
701,Dwane Casey,TOR,2,4,82,34,48,148,57,91,270,110,160,0.40700000000000003,,,,,,,,,,2012
702,Tyrone Corbin,UTA,3,3,82,43,39,176,87,89,176,87,89,0.494,,,,4.0,0.0,4.0,4.0,0.0,4.0,2012
703,Randy Wittman,WAS,2,7,82,29,53,131,47,84,438,147,291,0.336,,,,,,,,,,2012
704,Cotton Fitzsimmons,ATL,4,6,74,28,46,320,140,180,484,237,247,0.49,,,,6.0,2.0,4.0,6.0,2.0,4.0,1975
705,Gene Tormohlen,ATL,1,1,8,1,7,8,1,7,8,1,7,0.125,,,,,,,,,,1975
706,Tom Heinsohn,BOS,7,7,82,54,28,574,372,202,574,372,202,0.648,18.0,12.0,6.0,71.0,42.0,29.0,71.0,42.0,29.0,1975
707,Jack Ramsay,BUF,4,8,82,46,36,328,158,170,656,332,324,0.506,9.0,4.0,5.0,22.0,9.0,13.0,39.0,14.0,25.0,1975
708,Dick Motta,CHI,8,8,82,24,58,656,356,300,656,356,300,0.5429999999999999,,,,47.0,18.0,29.0,47.0,18.0,29.0,1975
709,Bill Fitch,CLE,6,6,82,49,33,492,188,304,492,188,304,0.382,13.0,6.0,7.0,13.0,6.0,7.0,13.0,6.0,7.0,1975
710,Ray Scott,DET,4,4,42,17,25,281,147,134,281,147,134,0.523,,,,10.0,4.0,6.0,10.0,4.0,6.0,1975
711,Herb Brown,DET,1,1,40,19,21,40,19,21,40,19,21,0.475,9.0,4.0,5.0,9.0,4.0,5.0,9.0,4.0,5.0,1975
712,Al Attles,GSW,7,7,82,59,23,522,298,224,522,298,224,0.5710000000000001,13.0,7.0,6.0,51.0,26.0,25.0,51.0,26.0,25.0,1975
713,Johnny Egan,HOU,4,4,82,40,42,281,129,152,281,129,152,0.45899999999999996,,,,8.0,3.0,5.0,8.0,3.0,5.0,1975
714,Phil Johnson,KCK,3,3,82,31,51,222,102,120,222,102,120,0.45899999999999996,,,,6.0,2.0,4.0,6.0,2.0,4.0,1975
715,Bill Sharman,LAL,5,10,82,40,42,410,246,164,819,466,353,0.569,,,,37.0,22.0,15.0,97.0,57.0,40.0,1975
716,Larry Costello,MIL,8,8,82,38,44,656,407,249,656,407,249,0.62,3.0,1.0,2.0,60.0,37.0,23.0,60.0,37.0,23.0,1975
717,Butch van Breda Kolff,NOJ,2,9,82,38,44,148,60,88,577,273,304,0.473,,,,,,,33.0,21.0,12.0,1975
718,Red Holzman,NYK,9,13,82,38,44,700,426,274,903,509,394,0.564,,,,95.0,54.0,41.0,103.0,58.0,45.0,1975
719,Gene Shue,PHI,3,10,82,46,36,246,105,141,794,396,398,0.499,3.0,1.0,2.0,3.0,1.0,2.0,43.0,15.0,28.0,1975
720,John MacLeod,PHO,3,3,82,42,40,246,104,142,246,104,142,0.423,19.0,10.0,9.0,19.0,10.0,9.0,19.0,10.0,9.0,1975
721,Lenny Wilkens,POR,2,5,82,37,45,164,75,89,410,196,214,0.478,,,,,,,,,,1975
722,Bill Russell,SEA,3,6,82,43,39,246,122,124,491,284,207,0.578,6.0,2.0,4.0,15.0,6.0,9.0,61.0,34.0,27.0,1975
723,K.C. Jones,WSB,3,4,82,48,34,246,155,91,330,185,145,0.561,7.0,3.0,4.0,31.0,14.0,17.0,35.0,14.0,21.0,1975
724,Larry Drew,ATL,2,2,66,40,26,148,84,64,148,84,64,0.568,6.0,2.0,4.0,18.0,8.0,10.0,18.0,8.0,10.0,2011
725,Doc Rivers,BOS,8,13,66,39,27,640,375,265,979,546,433,0.5579999999999999,20.0,11.0,9.0,100.0,57.0,43.0,115.0,62.0,53.0,2011
726,Paul Silas,CHA,6,12,66,7,59,401,193,208,875,387,488,0.442,,,,23.0,11.0,12.0,29.0,13.0,16.0,2011
727,Tom Thibodeau,CHI,2,2,66,50,16,148,112,36,148,112,36,0.757,6.0,2.0,4.0,22.0,11.0,11.0,22.0,11.0,11.0,2011
728,Byron Scott,CLE,2,12,66,21,45,148,40,108,855,392,463,0.45799999999999996,,,,,,,57.0,33.0,24.0,2011
729,Rick Carlisle,DAL,4,10,66,36,30,312,198,114,804,479,325,0.596,4.0,0.0,4.0,41.0,23.0,18.0,103.0,53.0,50.0,2011
730,George Karl,DEN,8,24,66,38,28,598,366,232,1805,1074,731,0.595,7.0,3.0,4.0,53.0,19.0,34.0,179.0,78.0,101.0,2011
731,Lawrence Frank,DET,1,8,66,25,41,66,25,41,532,250,282,0.47,,,,,,,38.0,18.0,20.0,2011
732,Mark Jackson,GSW,1,1,66,23,43,66,23,43,66,23,43,0.348,,,,,,,,,,2011
733,Kevin McHale,HOU,1,3,66,34,32,66,34,32,160,73,87,0.456,,,,,,,,,,2011
734,Frank Vogel,IND,2,2,66,42,24,104,62,42,104,62,42,0.596,11.0,6.0,5.0,16.0,7.0,9.0,16.0,7.0,9.0,2011
735,Vinny Del Negro,LAC,2,4,66,40,26,148,72,76,312,154,158,0.494,11.0,4.0,7.0,11.0,4.0,7.0,23.0,8.0,15.0,2011
736,Mike Brown,LAL,1,6,66,41,25,66,41,25,476,313,163,0.6579999999999999,12.0,5.0,7.0,12.0,5.0,7.0,83.0,47.0,36.0,2011
737,Lionel Hollins,MEM,6,6,66,41,25,333,158,175,333,158,175,0.474,7.0,3.0,4.0,20.0,10.0,10.0,20.0,10.0,10.0,2011
738,Erik Spoelstra,MIA,4,4,66,46,20,312,194,118,312,194,118,0.622,23.0,16.0,7.0,56.0,34.0,22.0,56.0,34.0,22.0,2011
739,Scott Skiles,MIL,4,12,66,31,35,312,146,166,844,427,417,0.506,,,,7.0,3.0,4.0,42.0,18.0,24.0,2011
740,Rick Adelman,MIN,1,21,66,26,40,66,26,40,1627,971,656,0.597,,,,,,,157.0,79.0,78.0,2011
741,Avery Johnson,NJN,2,6,66,22,44,148,46,102,412,240,172,0.583,,,,,,,47.0,23.0,24.0,2011
742,Monty Williams,NOH,2,2,66,21,45,148,67,81,148,67,81,0.45299999999999996,,,,6.0,2.0,4.0,6.0,2.0,4.0,2011
743,Mike D'Antoni,NYK,4,10,42,18,24,288,121,167,727,388,339,0.534,,,,4.0,0.0,4.0,55.0,26.0,29.0,2011
744,Mike Woodson,NYK,1,7,24,18,6,24,18,6,516,224,292,0.434,5.0,1.0,4.0,5.0,1.0,4.0,34.0,12.0,22.0,2011
745,Scott Brooks,OKC,4,4,66,47,19,299,174,125,299,174,125,0.5820000000000001,20.0,13.0,7.0,43.0,24.0,19.0,43.0,24.0,19.0,2011
746,Stan Van Gundy,ORL,5,8,66,37,29,394,259,135,579,371,208,0.6409999999999999,5.0,1.0,4.0,59.0,31.0,28.0,87.0,48.0,39.0,2011
747,Doug Collins,PHI,2,10,66,35,31,148,76,72,767,408,359,0.532,13.0,7.0,6.0,18.0,8.0,10.0,56.0,23.0,33.0,2011
748,Alvin Gentry,PHO,4,11,66,33,33,261,145,116,664,322,342,0.485,,,,16.0,10.0,6.0,21.0,12.0,9.0,2011
749,Nate McMillan,POR,7,12,43,20,23,535,266,269,930,478,452,0.514,,,,18.0,6.0,12.0,34.0,14.0,20.0,2011
750,Kaleb Canales,POR,1,1,23,8,15,23,8,15,23,8,15,0.348,,,,,,,,,,2011
751,Paul Westphal,SAC,3,10,7,2,5,171,51,120,597,318,279,0.5329999999999999,,,,,,,49.0,27.0,22.0,2011
752,Keith Smart,SAC,1,3,59,20,39,59,20,39,181,65,116,0.359,,,,,,,,,,2011
753,Gregg Popovich,SAS,16,16,66,50,16,1246,847,399,1246,847,399,0.68,14.0,10.0,4.0,195.0,118.0,77.0,195.0,118.0,77.0,2011
754,Dwane Casey,TOR,1,3,66,23,43,66,23,43,188,76,112,0.40399999999999997,,,,,,,,,,2011
755,Tyrone Corbin,UTA,2,2,66,36,30,94,44,50,94,44,50,0.46799999999999997,4.0,0.0,4.0,4.0,0.0,4.0,4.0,0.0,4.0,2011
756,Flip Saunders,WAS,3,16,17,2,15,181,51,130,1164,638,526,0.5479999999999999,,,,,,,98.0,47.0,51.0,2011
757,Randy Wittman,WAS,1,6,49,18,31,49,18,31,356,118,238,0.331,,,,,,,,,,2011
758,Hubie Brown,ATL,1,3,82,31,51,82,31,51,250,135,115,0.54,,,,,,,25.0,17.0,8.0,1976
759,Tom Heinsohn,BOS,8,8,82,44,38,656,416,240,656,416,240,0.634,9.0,5.0,4.0,80.0,47.0,33.0,80.0,47.0,33.0,1976
760,Tates Locke,BUF,1,1,46,16,30,46,16,30,46,16,30,0.348,,,,,,,,,,1976
761,Bob MacKinnon,BUF,1,2,7,3,4,7,3,4,91,35,56,0.385,,,,,,,10.0,5.0,5.0,1976
762,Joe Mullaney,BUF,1,8,29,11,18,29,11,18,566,322,244,0.569,,,,,,,78.0,39.0,39.0,1976
763,Ed Badger,CHI,1,1,82,44,38,82,44,38,82,44,38,0.537,3.0,1.0,2.0,3.0,1.0,2.0,3.0,1.0,2.0,1976
764,Bill Fitch,CLE,7,7,82,43,39,574,231,343,574,231,343,0.402,3.0,1.0,2.0,16.0,7.0,9.0,16.0,7.0,9.0,1976
765,Larry Brown,DEN,3,5,82,50,32,250,175,75,418,279,139,0.667,6.0,2.0,4.0,32.0,15.0,17.0,48.0,22.0,26.0,1976
766,Herb Brown,DET,2,2,82,44,38,122,63,59,122,63,59,0.516,3.0,1.0,2.0,12.0,5.0,7.0,12.0,5.0,7.0,1976
767,Al Attles,GSW,8,8,82,46,36,604,344,260,604,344,260,0.57,10.0,5.0,5.0,61.0,31.0,30.0,61.0,31.0,30.0,1976
768,Tom Nissalke,HOU,1,6,82,49,33,82,49,33,367,185,182,0.504,12.0,6.0,6.0,12.0,6.0,6.0,29.0,11.0,18.0,1976
769,Slick Leonard,IND,9,11,82,36,46,739,423,316,861,467,394,0.542,,,,116.0,69.0,47.0,116.0,69.0,47.0,1976
770,Phil Johnson,KCK,4,4,82,40,42,304,142,162,304,142,162,0.467,,,,6.0,2.0,4.0,6.0,2.0,4.0,1976
771,Jerry West,LAL,1,1,82,53,29,82,53,29,82,53,29,0.6459999999999999,11.0,4.0,7.0,11.0,4.0,7.0,11.0,4.0,7.0,1976
772,Larry Costello,MIL,9,9,18,3,15,674,410,264,674,410,264,0.608,,,,60.0,37.0,23.0,60.0,37.0,23.0,1976
773,Don Nelson,MIL,1,1,64,27,37,64,27,37,64,27,37,0.42200000000000004,,,,,,,,,,1976
774,Butch van Breda Kolff,NOJ,3,10,26,14,12,174,74,100,603,287,316,0.47600000000000003,,,,,,,33.0,21.0,12.0,1976
775,Elgin Baylor,NOJ,2,2,56,21,35,57,21,36,57,21,36,0.368,,,,,,,,,,1976
776,Red Holzman,NYK,10,14,82,40,42,782,466,316,985,549,436,0.557,,,,95.0,54.0,41.0,103.0,58.0,45.0,1976
777,Kevin Loughery,NYN,4,5,82,22,60,334,190,144,365,195,170,0.534,,,,32.0,21.0,11.0,32.0,21.0,11.0,1976
778,Gene Shue,PHI,4,11,82,50,32,328,155,173,876,446,430,0.509,19.0,10.0,9.0,22.0,11.0,11.0,62.0,25.0,37.0,1976
779,John MacLeod,PHO,4,4,82,34,48,328,138,190,328,138,190,0.42100000000000004,,,,19.0,10.0,9.0,19.0,10.0,9.0,1976
780,Jack Ramsay,POR,1,9,82,49,33,82,49,33,738,381,357,0.516,19.0,14.0,5.0,19.0,14.0,5.0,58.0,28.0,30.0,1976
781,Doug Moe,SAS,1,1,82,44,38,82,44,38,82,44,38,0.537,2.0,0.0,2.0,2.0,0.0,2.0,2.0,0.0,2.0,1976
782,Bill Russell,SEA,4,7,82,40,42,328,162,166,573,324,249,0.565,,,,15.0,6.0,9.0,61.0,34.0,27.0,1976
783,Dick Motta,WSB,1,9,82,48,34,82,48,34,738,404,334,0.547,9.0,4.0,5.0,9.0,4.0,5.0,56.0,22.0,34.0,1976
784,Red Auerbach,BOS,7,11,72,44,28,494,285,209,719,428,291,0.595,10.0,7.0,3.0,37.0,17.0,20.0,57.0,26.0,31.0,1956
785,Charles Eckman,FTW,3,3,72,34,38,216,114,102,216,114,102,0.528,2.0,0.0,2.0,23.0,10.0,13.0,23.0,10.0,13.0,1956
786,John Kundla,MNL,9,9,72,34,38,620,380,240,620,380,240,0.613,5.0,2.0,3.0,82.0,54.0,28.0,82.0,54.0,28.0,1956
787,Vince Boryla,NYK,2,2,72,36,36,93,45,48,93,45,48,0.484,,,,,,,,,,1956
788,George Senesky,PHW,2,2,72,37,35,144,82,62,144,82,62,0.569,2.0,0.0,2.0,12.0,7.0,5.0,12.0,7.0,5.0,1956
789,Bobby Wanzer,ROC,2,2,72,31,41,144,62,82,144,62,82,0.431,,,,,,,,,,1956
790,Red Holzman,STL,4,4,33,14,19,203,83,120,203,83,120,0.409,,,,8.0,4.0,4.0,8.0,4.0,4.0,1956
791,Slater Martin,STL,1,1,8,5,3,8,5,3,8,5,3,0.625,,,,,,,,,,1956
792,Alex Hannum,STL,1,1,31,15,16,31,15,16,31,15,16,0.484,10.0,6.0,4.0,10.0,6.0,4.0,10.0,6.0,4.0,1956
793,Al Cervi,SYR,8,8,12,4,8,495,294,201,495,294,201,0.594,,,,59.0,33.0,26.0,59.0,33.0,26.0,1956
794,Paul Seymour,SYR,1,1,60,34,26,60,34,26,60,34,26,0.5670000000000001,5.0,2.0,3.0,5.0,2.0,3.0,5.0,2.0,3.0,1956
795,Hubie Brown,ATL,2,4,82,41,41,164,72,92,332,176,156,0.53,2.0,0.0,2.0,2.0,0.0,2.0,27.0,17.0,10.0,1977
796,Tom Heinsohn,BOS,9,9,34,11,23,690,427,263,690,427,263,0.619,,,,80.0,47.0,33.0,80.0,47.0,33.0,1977
797,Tom Sanders,BOS,1,1,48,21,27,48,21,27,48,21,27,0.43799999999999994,,,,,,,,,,1977
798,Cotton Fitzsimmons,BUF,1,7,82,27,55,82,27,55,566,264,302,0.466,,,,,,,6.0,2.0,4.0,1977
799,Ed Badger,CHI,2,2,82,40,42,164,84,80,164,84,80,0.512,,,,3.0,1.0,2.0,3.0,1.0,2.0,1977
800,Bill Fitch,CLE,8,8,82,43,39,656,274,382,656,274,382,0.418,2.0,0.0,2.0,18.0,7.0,11.0,18.0,7.0,11.0,1977
801,Larry Brown,DEN,4,6,82,48,34,332,223,109,500,327,173,0.654,13.0,6.0,7.0,45.0,21.0,24.0,61.0,28.0,33.0,1977
802,Herb Brown,DET,3,3,24,9,15,146,72,74,146,72,74,0.493,,,,12.0,5.0,7.0,12.0,5.0,7.0,1977
803,Bob Kauffman,DET,1,1,58,29,29,58,29,29,58,29,29,0.5,,,,,,,,,,1977
804,Al Attles,GSW,9,9,82,43,39,686,387,299,686,387,299,0.564,,,,61.0,31.0,30.0,61.0,31.0,30.0,1977
805,Tom Nissalke,HOU,2,7,82,28,54,164,77,87,449,213,236,0.474,,,,12.0,6.0,6.0,29.0,11.0,18.0,1977
806,Slick Leonard,IND,10,12,82,31,51,821,454,367,943,498,445,0.528,,,,116.0,69.0,47.0,116.0,69.0,47.0,1977
807,Phil Johnson,KCK,5,5,37,13,24,341,155,186,341,155,186,0.455,,,,6.0,2.0,4.0,6.0,2.0,4.0,1977
808,Larry Staverman,KCK,1,3,45,18,27,45,18,27,132,58,74,0.439,,,,,,,3.0,0.0,3.0,1977
809,Jerry West,LAL,2,2,82,45,37,164,98,66,164,98,66,0.598,3.0,1.0,2.0,14.0,5.0,9.0,14.0,5.0,9.0,1977
810,Don Nelson,MIL,2,2,82,44,38,146,71,75,146,71,75,0.486,9.0,5.0,4.0,9.0,5.0,4.0,9.0,5.0,4.0,1977
811,Kevin Loughery,NJN,5,6,82,24,58,416,214,202,447,219,228,0.49,,,,32.0,21.0,11.0,32.0,21.0,11.0,1977
812,Elgin Baylor,NOJ,3,3,82,39,43,139,60,79,139,60,79,0.43200000000000005,,,,,,,,,,1977
813,Willis Reed,NYK,1,1,82,43,39,82,43,39,82,43,39,0.524,6.0,2.0,4.0,6.0,2.0,4.0,6.0,2.0,4.0,1977
814,Gene Shue,PHI,5,12,6,2,4,334,157,177,882,448,434,0.508,,,,22.0,11.0,11.0,62.0,25.0,37.0,1977
815,Billy Cunningham,PHI,1,1,76,53,23,76,53,23,76,53,23,0.6970000000000001,10.0,6.0,4.0,10.0,6.0,4.0,10.0,6.0,4.0,1977
816,John MacLeod,PHO,5,5,82,49,33,410,187,223,410,187,223,0.456,2.0,0.0,2.0,21.0,10.0,11.0,21.0,10.0,11.0,1977
817,Jack Ramsay,POR,2,10,82,58,24,164,107,57,820,439,381,0.535,6.0,2.0,4.0,25.0,16.0,9.0,64.0,30.0,34.0,1977
818,Doug Moe,SAS,2,2,82,52,30,164,96,68,164,96,68,0.585,6.0,2.0,4.0,8.0,2.0,6.0,8.0,2.0,6.0,1977
819,Bob Hopkins,SEA,1,1,22,5,17,22,5,17,22,5,17,0.22699999999999998,,,,,,,,,,1977
820,Lenny Wilkens,SEA,4,6,60,42,18,306,163,143,470,238,232,0.506,22.0,13.0,9.0,22.0,13.0,9.0,22.0,13.0,9.0,1977
821,Dick Motta,WSB,2,10,82,44,38,164,92,72,820,448,372,0.546,21.0,14.0,7.0,30.0,18.0,12.0,77.0,36.0,41.0,1977
822,Paul Seymour,BAL,1,7,80,38,42,80,38,42,452,249,203,0.551,3.0,0.0,3.0,3.0,0.0,3.0,35.0,14.0,21.0,1965
823,Red Auerbach,BOS,16,20,80,54,26,1192,795,397,1417,938,479,0.662,17.0,11.0,6.0,148.0,90.0,58.0,168.0,99.0,69.0,1965
824,Jack McMahon,CIN,3,4,80,45,35,240,148,92,278,160,118,0.5760000000000001,5.0,2.0,3.0,19.0,7.0,12.0,19.0,7.0,12.0,1965
825,Dave DeBusschere,DET,2,2,80,22,58,149,51,98,149,51,98,0.342,,,,,,,,,,1965
826,Fred Schaus,LAL,6,6,80,45,35,479,279,200,479,279,200,0.5820000000000001,14.0,7.0,7.0,68.0,33.0,35.0,68.0,33.0,35.0,1965
827,Harry Gallatin,NYK,2,4,21,6,15,63,25,38,256,136,120,0.531,,,,,,,23.0,12.0,11.0,1965
828,Dick McGuire,NYK,1,5,59,24,35,59,24,35,339,146,193,0.431,,,,,,,21.0,8.0,13.0,1965
829,Dolph Schayes,PHI,3,3,80,55,25,240,129,111,240,129,111,0.5379999999999999,5.0,1.0,4.0,21.0,9.0,12.0,21.0,9.0,12.0,1965
830,Alex Hannum,SFW,3,8,80,35,45,240,100,140,582,283,299,0.486,,,,12.0,5.0,7.0,51.0,27.0,24.0,1965
831,Richie Guerin,STL,2,2,80,36,44,127,64,63,127,64,63,0.504,10.0,6.0,4.0,14.0,7.0,7.0,14.0,7.0,7.0,1965
832,Buddy Jeannette,BAL,1,5,80,37,43,80,37,43,293,133,160,0.45399999999999996,10.0,5.0,5.0,10.0,5.0,5.0,24.0,14.0,10.0,1964
833,Red Auerbach,BOS,15,19,80,62,18,1112,741,371,1337,884,453,0.6609999999999999,12.0,8.0,4.0,131.0,79.0,52.0,151.0,88.0,63.0,1964
834,Jack McMahon,CIN,2,3,80,48,32,160,103,57,198,115,83,0.581,4.0,1.0,3.0,14.0,5.0,9.0,14.0,5.0,9.0,1964
835,Charles Wolf,DET,2,5,11,2,9,91,25,66,330,143,187,0.433,,,,,,,16.0,7.0,9.0,1964
836,Dave DeBusschere,DET,1,1,69,29,40,69,29,40,69,29,40,0.42,,,,,,,,,,1964
837,Fred Schaus,LAL,5,5,80,49,31,399,234,165,399,234,165,0.586,11.0,5.0,6.0,54.0,26.0,28.0,54.0,26.0,28.0,1964
838,Eddie Donovan,NYK,4,4,38,12,26,278,84,194,278,84,194,0.302,,,,,,,,,,1964
839,Harry Gallatin,NYK,1,3,42,19,23,42,19,23,235,130,105,0.5529999999999999,,,,,,,23.0,12.0,11.0,1964
840,Dolph Schayes,PHI,2,2,80,40,40,160,74,86,160,74,86,0.46299999999999997,11.0,6.0,5.0,16.0,8.0,8.0,16.0,8.0,8.0,1964
841,Alex Hannum,SFW,2,7,80,17,63,160,65,95,502,248,254,0.494,,,,12.0,5.0,7.0,51.0,27.0,24.0,1964
842,Harry Gallatin,STL,3,3,33,17,16,193,111,82,235,130,105,0.5529999999999999,,,,23.0,12.0,11.0,23.0,12.0,11.0,1964
843,Richie Guerin,STL,1,1,47,28,19,47,28,19,47,28,19,0.596,4.0,1.0,3.0,4.0,1.0,3.0,4.0,1.0,3.0,1964
844,Slick Leonard,BAL,2,2,80,31,49,122,44,78,122,44,78,0.361,,,,,,,,,,1963
845,Red Auerbach,BOS,14,18,80,59,21,1032,679,353,1257,822,435,0.654,10.0,8.0,2.0,119.0,71.0,48.0,139.0,80.0,59.0,1963
846,Jack McMahon,CIN,1,2,80,55,25,80,55,25,118,67,51,0.568,10.0,4.0,6.0,10.0,4.0,6.0,10.0,4.0,6.0,1963
847,Charles Wolf,DET,1,4,80,23,57,80,23,57,319,141,178,0.442,,,,,,,16.0,7.0,9.0,1963
848,Fred Schaus,LAL,4,4,80,42,38,319,185,134,319,185,134,0.58,5.0,2.0,3.0,43.0,21.0,22.0,43.0,21.0,22.0,1963
849,Eddie Donovan,NYK,3,3,80,22,58,240,72,168,240,72,168,0.3,,,,,,,,,,1963
850,Dolph Schayes,PHI,1,1,80,34,46,80,34,46,80,34,46,0.425,5.0,2.0,3.0,5.0,2.0,3.0,5.0,2.0,3.0,1963
851,Alex Hannum,SFW,1,6,80,48,32,80,48,32,422,231,191,0.547,12.0,5.0,7.0,12.0,5.0,7.0,51.0,27.0,24.0,1963
852,Harry Gallatin,STL,2,2,80,46,34,160,94,66,160,94,66,0.588,12.0,6.0,6.0,23.0,12.0,11.0,23.0,12.0,11.0,1963
853,Lenny Wilkens,ATL,4,24,82,56,26,328,201,127,1946,1070,876,0.55,10.0,4.0,6.0,34.0,13.0,21.0,144.0,68.0,76.0,1996
854,M.L. Carr,BOS,2,2,82,15,67,164,48,116,164,48,116,0.293,,,,,,,,,,1996
855,Dave Cowens,CHH,1,2,82,54,28,82,54,28,150,81,69,0.54,3.0,0.0,3.0,3.0,0.0,3.0,3.0,0.0,3.0,1996
856,Phil Jackson,CHI,8,8,82,69,13,656,483,173,656,483,173,0.736,19.0,15.0,4.0,131.0,96.0,35.0,131.0,96.0,35.0,1996
857,Mike Fratello,CLE,4,12,82,42,40,328,179,149,905,503,402,0.556,,,,10.0,1.0,9.0,50.0,19.0,31.0,1996
858,Jim Cleamons,DAL,1,1,82,24,58,82,24,58,82,24,58,0.293,,,,,,,,,,1996
859,Bernie Bickerstaff,DEN,3,8,13,4,9,127,59,68,572,283,289,0.495,,,,3.0,0.0,3.0,33.0,12.0,21.0,1996
860,Dick Motta,DEN,1,25,69,17,52,69,17,52,1952,935,1017,0.479,,,,,,,126.0,56.0,70.0,1996
861,Doug Collins,DET,2,5,82,54,28,164,100,64,410,237,173,0.578,5.0,2.0,3.0,8.0,2.0,6.0,38.0,15.0,23.0,1996
862,Rick Adelman,GSW,2,8,82,30,52,164,66,98,609,357,252,0.586,,,,,,,69.0,36.0,33.0,1996
863,Rudy Tomjanovich,HOU,6,6,82,57,25,440,281,159,440,281,159,0.639,16.0,9.0,7.0,81.0,48.0,33.0,81.0,48.0,33.0,1996
864,Larry Brown,IND,4,18,82,39,43,328,190,138,1440,853,587,0.5920000000000001,,,,38.0,22.0,16.0,125.0,61.0,64.0,1996
865,Bill Fitch,LAC,3,24,82,36,46,246,82,164,1968,927,1041,0.47100000000000003,3.0,0.0,3.0,3.0,0.0,3.0,109.0,55.0,54.0,1996
866,Del Harris,LAL,3,12,82,56,26,246,157,89,919,489,430,0.532,9.0,4.0,5.0,23.0,10.0,13.0,75.0,31.0,44.0,1996
867,Pat Riley,MIA,2,15,82,61,21,164,103,61,1219,859,360,0.705,17.0,8.0,9.0,20.0,8.0,12.0,232.0,145.0,87.0,1996
868,Chris Ford,MIL,1,6,82,33,49,82,33,49,492,255,237,0.518,,,,,,,29.0,13.0,16.0,1996
869,Flip Saunders,MIN,2,2,82,40,42,144,60,84,144,60,84,0.41700000000000004,3.0,0.0,3.0,3.0,0.0,3.0,3.0,0.0,3.0,1996
870,John Calipari,NJN,1,1,82,26,56,82,26,56,82,26,56,0.317,,,,,,,,,,1996
871,Jeff Van Gundy,NYK,2,2,82,57,25,105,70,35,105,70,35,0.667,10.0,6.0,4.0,18.0,10.0,8.0,18.0,10.0,8.0,1996
872,Brian Hill,ORL,4,4,49,24,25,295,191,104,295,191,104,0.647,,,,36.0,18.0,18.0,36.0,18.0,18.0,1996
873,Richie Adubato,ORL,1,6,33,21,12,33,21,12,367,127,240,0.34600000000000003,5.0,2.0,3.0,5.0,2.0,3.0,8.0,2.0,6.0,1996
874,Johnny Davis,PHI,1,1,82,22,60,82,22,60,82,22,60,0.268,,,,,,,,,,1996
875,Cotton Fitzsimmons,PHO,8,21,8,0,8,549,341,208,1607,832,775,0.518,,,,44.0,22.0,22.0,84.0,35.0,49.0,1996
876,Danny Ainge,PHO,1,1,74,40,34,74,40,34,74,40,34,0.541,5.0,2.0,3.0,5.0,2.0,3.0,5.0,2.0,3.0,1996
877,P.J. Carlesimo,POR,3,3,82,49,33,246,137,109,246,137,109,0.557,4.0,1.0,3.0,12.0,3.0,9.0,12.0,3.0,9.0,1996
878,Garry St. Jean,SAC,5,5,67,28,39,395,159,236,395,159,236,0.40299999999999997,,,,4.0,1.0,3.0,4.0,1.0,3.0,1996
879,Eddie Jordan,SAC,1,1,15,6,9,15,6,9,15,6,9,0.4,,,,,,,,,,1996
880,Bob Hill,SAS,3,7,18,3,15,182,124,58,469,257,212,0.5479999999999999,,,,25.0,14.0,11.0,37.0,17.0,20.0,1996
881,Gregg Popovich,SAS,1,1,64,17,47,64,17,47,64,17,47,0.266,,,,,,,,,,1996
882,George Karl,SEA,6,10,82,57,25,452,323,129,747,442,305,0.5920000000000001,12.0,6.0,6.0,70.0,36.0,34.0,84.0,41.0,43.0,1996
883,Darrell Walker,TOR,1,1,82,30,52,82,30,52,82,30,52,0.366,,,,,,,,,,1996
884,Jerry Sloan,UTA,9,12,82,64,18,721,483,238,936,577,359,0.616,20.0,13.0,7.0,97.0,50.0,47.0,103.0,52.0,51.0,1996
885,Brian Winters,VAN,2,2,43,8,35,125,23,102,125,23,102,0.184,,,,,,,,,,1996
886,Stu Jackson,VAN,1,3,39,6,33,39,6,33,136,58,78,0.426,,,,,,,10.0,4.0,6.0,1996
887,Jim Lynam,WSB,3,10,46,22,24,210,82,128,720,328,392,0.456,,,,,,,21.0,8.0,13.0,1996
888,Bob Staak,WSB,1,1,1,0,1,1,0,1,1,0,1,0.0,,,,,,,,,,1996
889,Bernie Bickerstaff,WSB,1,8,35,22,13,35,22,13,572,283,289,0.495,3.0,0.0,3.0,3.0,0.0,3.0,33.0,12.0,21.0,1996
890,Gene Shue,BAL,2,2,82,36,46,138,52,86,138,52,86,0.377,,,,,,,,,,1967
891,Bill Russell,BOS,2,2,82,54,28,163,114,49,163,114,49,0.6990000000000001,19.0,12.0,7.0,28.0,16.0,12.0,28.0,16.0,12.0,1967
892,Red Kerr,CHI,2,2,82,29,53,163,62,101,163,62,101,0.38,5.0,1.0,4.0,8.0,1.0,7.0,8.0,1.0,7.0,1967
893,Ed Jucker,CIN,1,1,82,39,43,82,39,43,82,39,43,0.47600000000000003,,,,,,,,,,1967
894,Donnie Butcher,DET,2,2,82,40,42,90,42,48,90,42,48,0.467,6.0,2.0,4.0,6.0,2.0,4.0,6.0,2.0,4.0,1967
895,Butch van Breda Kolff,LAL,1,1,82,52,30,82,52,30,82,52,30,0.634,15.0,10.0,5.0,15.0,10.0,5.0,15.0,10.0,5.0,1967
896,Dick McGuire,NYK,3,7,38,15,23,178,75,103,458,197,261,0.43,,,,4.0,1.0,3.0,25.0,9.0,16.0,1967
897,Red Holzman,NYK,1,5,44,28,16,44,28,16,247,111,136,0.449,6.0,2.0,4.0,6.0,2.0,4.0,14.0,6.0,8.0,1967
898,Alex Hannum,PHI,5,10,82,62,20,402,257,145,745,413,332,0.5539999999999999,13.0,7.0,6.0,46.0,26.0,20.0,79.0,45.0,34.0,1967
899,Jack McMahon,SDR,1,6,82,15,67,82,15,67,441,214,227,0.485,,,,,,,23.0,8.0,15.0,1967
900,Al Bianchi,SEA,1,1,82,23,59,82,23,59,82,23,59,0.28,,,,,,,,,,1967
901,Bill Sharman,SFW,2,2,82,43,39,163,87,76,163,87,76,0.534,10.0,4.0,6.0,25.0,13.0,12.0,25.0,13.0,12.0,1967
902,Richie Guerin,STL,4,4,82,56,26,290,159,131,290,159,131,0.5479999999999999,6.0,2.0,4.0,29.0,14.0,15.0,29.0,14.0,15.0,1967
903,Cotton Fitzsimmons,ATL,3,5,82,31,51,246,112,134,410,209,201,0.51,,,,6.0,2.0,4.0,6.0,2.0,4.0,1974
904,Tom Heinsohn,BOS,6,6,82,60,22,492,318,174,492,318,174,0.6459999999999999,11.0,6.0,5.0,53.0,30.0,23.0,53.0,30.0,23.0,1974
905,Jack Ramsay,BUF,3,7,82,49,33,246,112,134,574,286,288,0.498,7.0,3.0,4.0,13.0,5.0,8.0,30.0,10.0,20.0,1974
906,Dick Motta,CHI,7,7,82,47,35,574,332,242,574,332,242,0.578,13.0,7.0,6.0,47.0,18.0,29.0,47.0,18.0,29.0,1974
907,Bill Fitch,CLE,5,5,82,40,42,410,139,271,410,139,271,0.33899999999999997,,,,,,,,,,1974
908,Ray Scott,DET,3,3,82,40,42,239,130,109,239,130,109,0.544,3.0,1.0,2.0,10.0,4.0,6.0,10.0,4.0,6.0,1974
909,Al Attles,GSW,6,6,82,48,34,440,239,201,440,239,201,0.5429999999999999,17.0,12.0,5.0,38.0,19.0,19.0,38.0,19.0,19.0,1974
910,Johnny Egan,HOU,3,3,82,41,41,199,89,110,199,89,110,0.447,8.0,3.0,5.0,8.0,3.0,5.0,8.0,3.0,5.0,1974
911,Phil Johnson,KCO,2,2,82,44,38,140,71,69,140,71,69,0.507,6.0,2.0,4.0,6.0,2.0,4.0,6.0,2.0,4.0,1974
912,Bill Sharman,LAL,4,9,82,30,52,328,206,122,737,426,311,0.578,,,,37.0,22.0,15.0,97.0,57.0,40.0,1974
913,Larry Costello,MIL,7,7,82,38,44,574,369,205,574,369,205,0.643,,,,57.0,36.0,21.0,57.0,36.0,21.0,1974
914,Scotty Robertson,NOJ,1,1,15,1,14,15,1,14,15,1,14,0.067,,,,,,,,,,1974
915,Elgin Baylor,NOJ,1,1,1,0,1,1,0,1,1,0,1,0.0,,,,,,,,,,1974
916,Butch van Breda Kolff,NOJ,1,8,66,22,44,66,22,44,495,235,260,0.475,,,,,,,33.0,21.0,12.0,1974
917,Red Holzman,NYK,8,12,82,40,42,618,388,230,821,471,350,0.574,3.0,1.0,2.0,95.0,54.0,41.0,103.0,58.0,45.0,1974
918,Gene Shue,PHI,2,9,82,34,48,164,59,105,712,350,362,0.49200000000000005,,,,,,,40.0,14.0,26.0,1974
919,John MacLeod,PHO,2,2,82,32,50,164,62,102,164,62,102,0.37799999999999995,,,,,,,,,,1974
920,Lenny Wilkens,POR,1,4,82,38,44,82,38,44,328,159,169,0.485,,,,,,,,,,1974
921,Bill Russell,SEA,2,5,82,43,39,164,79,85,409,241,168,0.589,9.0,4.0,5.0,9.0,4.0,5.0,55.0,32.0,23.0,1974
922,K.C. Jones,WSB,2,3,82,60,22,164,107,57,248,137,111,0.552,17.0,8.0,9.0,24.0,11.0,13.0,28.0,11.0,17.0,1974
923,Bob Weiss,ATL,1,3,82,43,39,82,43,39,246,102,144,0.415,5.0,2.0,3.0,5.0,2.0,3.0,8.0,2.0,6.0,1990
924,Chris Ford,BOS,1,1,82,56,26,82,56,26,82,56,26,0.6829999999999999,11.0,5.0,6.0,11.0,5.0,6.0,11.0,5.0,6.0,1990
925,Gene Littles,CHH,2,3,82,26,56,124,37,87,139,41,98,0.295,,,,,,,,,,1990
926,Phil Jackson,CHI,2,2,82,61,21,164,116,48,164,116,48,0.7070000000000001,17.0,15.0,2.0,33.0,25.0,8.0,33.0,25.0,8.0,1990
927,Lenny Wilkens,CLE,5,18,82,33,49,410,205,205,1454,758,696,0.521,,,,15.0,6.0,9.0,84.0,43.0,41.0,1990
928,Richie Adubato,DAL,2,3,82,28,54,153,70,83,223,82,141,0.368,,,,3.0,0.0,3.0,3.0,0.0,3.0,1990
929,Paul Westhead,DEN,1,5,82,20,62,82,20,62,325,159,166,0.489,,,,,,,19.0,13.0,6.0,1990
930,Chuck Daly,DET,8,9,82,50,32,656,419,237,697,428,269,0.614,15.0,7.0,8.0,108.0,69.0,39.0,108.0,69.0,39.0,1990
931,Don Nelson,GSW,3,14,82,44,38,246,124,122,1130,664,466,0.588,9.0,4.0,5.0,17.0,8.0,9.0,105.0,50.0,55.0,1990
932,Don Chaney,HOU,3,6,82,52,30,246,138,108,431,191,240,0.44299999999999995,3.0,0.0,3.0,11.0,2.0,9.0,11.0,2.0,9.0,1990
933,Dick Versace,IND,3,3,25,9,16,160,73,87,160,73,87,0.456,,,,3.0,0.0,3.0,3.0,0.0,3.0,1990
934,Bob Hill,IND,1,2,57,32,25,57,32,25,123,52,71,0.423,5.0,2.0,3.0,5.0,2.0,3.0,5.0,2.0,3.0,1990
935,Mike Schuler,LAC,1,4,82,31,51,82,31,51,293,158,135,0.539,,,,,,,8.0,2.0,6.0,1990
936,Mike Dunleavy,LAL,1,1,82,58,24,82,58,24,82,58,24,0.7070000000000001,19.0,12.0,7.0,19.0,12.0,7.0,19.0,12.0,7.0,1990
937,Ron Rothstein,MIA,3,3,82,24,58,246,57,189,246,57,189,0.23199999999999998,,,,,,,,,,1990
938,Del Harris,MIL,4,8,82,48,34,328,183,145,656,324,332,0.494,3.0,0.0,3.0,21.0,6.0,15.0,52.0,21.0,31.0,1990
939,Bill Musselman,MIN,2,5,82,29,53,164,51,113,295,85,210,0.28800000000000003,,,,,,,,,,1990
940,Bill Fitch,NJN,2,20,82,26,56,164,43,121,1640,805,835,0.491,,,,,,,102.0,54.0,48.0,1990
941,Stu Jackson,NYK,2,2,15,7,8,97,52,45,97,52,45,0.536,,,,10.0,4.0,6.0,10.0,4.0,6.0,1990
942,John MacLeod,NYK,1,18,67,32,35,67,32,35,1364,707,657,0.518,3.0,0.0,3.0,3.0,0.0,3.0,101.0,47.0,54.0,1990
943,Matt Guokas,ORL,2,5,82,31,51,164,49,115,371,168,203,0.45299999999999996,,,,,,,17.0,8.0,9.0,1990
944,Jim Lynam,PHI,4,6,82,44,38,285,159,126,428,211,217,0.493,8.0,4.0,4.0,21.0,8.0,13.0,21.0,8.0,13.0,1990
945,Cotton Fitzsimmons,PHO,5,18,82,55,27,410,261,149,1468,752,716,0.512,4.0,1.0,3.0,32.0,17.0,15.0,72.0,30.0,42.0,1990
946,Rick Adelman,POR,3,3,82,63,19,199,136,63,199,136,63,0.6829999999999999,16.0,9.0,7.0,40.0,21.0,19.0,40.0,21.0,19.0,1990
947,Dick Motta,SAC,2,21,82,25,57,136,41,95,1694,849,845,0.501,,,,,,,126.0,56.0,70.0,1990
948,Larry Brown,SAS,3,12,82,55,27,246,132,114,957,578,379,0.604,4.0,1.0,3.0,14.0,7.0,7.0,77.0,35.0,42.0,1990
949,K.C. Jones,SEA,1,10,82,41,41,82,41,41,822,534,288,0.65,5.0,2.0,3.0,5.0,2.0,3.0,142.0,81.0,61.0,1990
950,Jerry Sloan,UTA,3,6,82,54,28,229,149,80,444,243,201,0.547,9.0,4.0,5.0,17.0,6.0,11.0,23.0,8.0,15.0,1990
951,Wes Unseld,WSB,4,4,82,30,52,301,131,170,301,131,170,0.435,,,,5.0,2.0,3.0,5.0,2.0,3.0,1990
952,Mike Budenholzer,ATL,5,5,82,24,58,410,213,197,410,213,197,0.52,,,,39.0,17.0,22.0,39.0,17.0,22.0,2017
953,Brad Stevens,BOS,5,5,82,55,27,410,221,189,410,221,189,0.539,19.0,11.0,8.0,47.0,22.0,25.0,47.0,22.0,25.0,2017
954,Kenny Atkinson,BRK,2,2,82,28,54,164,48,116,164,48,116,0.293,,,,,,,,,,2017
955,Fred Hoiberg,CHI,3,3,82,27,55,246,110,136,246,110,136,0.447,,,,6.0,2.0,4.0,6.0,2.0,4.0,2017
956,Steve Clifford,CHO,5,5,82,36,46,410,196,214,410,196,214,0.478,,,,11.0,3.0,8.0,11.0,3.0,8.0,2017
957,Tyronn Lue,CLE,3,3,82,50,32,205,128,77,205,128,77,0.624,22.0,12.0,10.0,61.0,41.0,20.0,61.0,41.0,20.0,2017
958,Rick Carlisle,DAL,10,16,82,24,58,804,437,367,1296,718,578,0.5539999999999999,,,,58.0,28.0,30.0,120.0,58.0,62.0,2017
959,Mike Malone,DEN,3,5,82,46,36,246,119,127,352,158,194,0.449,,,,,,,,,,2017
960,Stan Van Gundy,DET,4,12,82,39,43,328,152,176,907,523,384,0.5770000000000001,,,,4.0,0.0,4.0,91.0,48.0,43.0,2017
961,Steve Kerr,GSW,4,4,82,58,24,328,265,63,328,265,63,0.8079999999999999,21.0,16.0,5.0,83.0,63.0,20.0,83.0,63.0,20.0,2017
962,Mike D'Antoni,HOU,2,14,82,65,17,164,120,44,1045,575,470,0.55,17.0,11.0,6.0,28.0,17.0,11.0,87.0,43.0,44.0,2017
963,Nate McMillan,IND,2,14,82,48,34,164,90,74,1094,568,526,0.519,7.0,3.0,4.0,11.0,3.0,8.0,45.0,17.0,28.0,2017
964,Doc Rivers,LAC,5,19,82,42,40,410,259,151,1470,846,624,0.5760000000000001,,,,40.0,18.0,22.0,161.0,82.0,79.0,2017
965,Luke Walton,LAL,2,2,82,35,47,164,61,103,164,61,103,0.37200000000000005,,,,,,,,,,2017
966,David Fizdale,MEM,2,2,19,7,12,101,50,51,101,50,51,0.495,,,,6.0,2.0,4.0,6.0,2.0,4.0,2017
967,J.B. Bickerstaff,MEM,1,2,63,15,48,63,15,48,134,52,82,0.38799999999999996,,,,,,,5.0,1.0,4.0,2017
968,Erik Spoelstra,MIA,10,10,82,44,38,804,484,320,804,484,320,0.602,5.0,1.0,4.0,118.0,71.0,47.0,118.0,71.0,47.0,2017
969,Jason Kidd,MIL,4,5,45,23,22,291,139,152,373,183,190,0.491,,,,12.0,4.0,8.0,24.0,9.0,15.0,2017
970,Joe Prunty,MIL,1,1,37,21,16,37,21,16,37,21,16,0.568,7.0,3.0,4.0,7.0,3.0,4.0,7.0,3.0,4.0,2017
971,Tom Thibodeau,MIN,2,7,82,47,35,164,78,86,558,333,225,0.597,5.0,1.0,4.0,5.0,1.0,4.0,56.0,24.0,32.0,2017
972,Alvin Gentry,NOP,3,15,82,48,34,246,112,134,951,447,504,0.47,9.0,5.0,4.0,9.0,5.0,4.0,30.0,17.0,13.0,2017
973,Jeff Hornacek,NYK,2,5,82,29,53,164,60,104,377,161,216,0.42700000000000005,,,,,,,,,,2017
974,Billy Donovan,OKC,3,3,82,48,34,246,150,96,246,150,96,0.61,6.0,2.0,4.0,29.0,14.0,15.0,29.0,14.0,15.0,2017
975,Frank Vogel,ORL,2,8,82,25,57,164,54,110,595,304,291,0.511,,,,,,,61.0,31.0,30.0,2017
976,Brett Brown,PHI,5,5,82,52,30,410,127,283,410,127,283,0.31,10.0,5.0,5.0,10.0,5.0,5.0,10.0,5.0,5.0,2017
977,Earl Watson,PHO,3,3,3,0,3,118,33,85,118,33,85,0.28,,,,,,,,,,2017
978,Jay Triano,PHO,1,4,79,21,58,79,21,58,308,108,200,0.35100000000000003,,,,,,,,,,2017
979,Terry Stotts,POR,6,10,82,49,33,492,272,220,775,387,388,0.499,4.0,0.0,4.0,35.0,11.0,24.0,40.0,12.0,28.0,2017
980,Dave Joerger,SAC,2,5,82,27,55,164,59,105,410,206,204,0.502,,,,,,,22.0,9.0,13.0,2017
981,Gregg Popovich,SAS,22,22,82,47,35,1738,1197,541,1738,1197,541,0.6890000000000001,5.0,1.0,4.0,277.0,167.0,110.0,277.0,167.0,110.0,2017
982,Dwane Casey,TOR,7,9,82,59,23,558,320,238,680,373,307,0.5489999999999999,10.0,4.0,6.0,51.0,21.0,30.0,51.0,21.0,30.0,2017
983,Quin Snyder,UTA,4,4,82,48,34,328,177,151,328,177,151,0.54,11.0,5.0,6.0,22.0,9.0,13.0,22.0,9.0,13.0,2017
984,Scott Brooks,WAS,2,9,82,43,39,164,92,72,709,430,279,0.606,6.0,2.0,4.0,19.0,9.0,10.0,92.0,48.0,44.0,2017
985,Larry Drew,ATL,1,1,82,44,38,82,44,38,82,44,38,0.537,12.0,6.0,6.0,12.0,6.0,6.0,12.0,6.0,6.0,2010
986,Doc Rivers,BOS,7,12,82,56,26,574,336,238,913,507,406,0.555,9.0,5.0,4.0,80.0,46.0,34.0,95.0,51.0,44.0,2010
987,Larry Brown,CHA,3,30,28,9,19,192,88,104,2338,1327,1011,0.568,,,,4.0,0.0,4.0,235.0,120.0,115.0,2010
988,Paul Silas,CHA,5,11,54,25,29,335,186,149,809,380,429,0.47,,,,23.0,11.0,12.0,29.0,13.0,16.0,2010
989,Tom Thibodeau,CHI,1,1,82,62,20,82,62,20,82,62,20,0.7559999999999999,16.0,9.0,7.0,16.0,9.0,7.0,16.0,9.0,7.0,2010
990,Byron Scott,CLE,1,11,82,19,63,82,19,63,789,371,418,0.47,,,,,,,57.0,33.0,24.0,2010
991,Rick Carlisle,DAL,3,9,82,57,25,246,162,84,738,443,295,0.6,21.0,16.0,5.0,37.0,23.0,14.0,99.0,53.0,46.0,2010
992,George Karl,DEN,7,23,82,50,32,532,328,204,1739,1036,703,0.596,5.0,1.0,4.0,46.0,16.0,30.0,172.0,75.0,97.0,2010
993,John Kuester,DET,2,2,82,30,52,164,57,107,164,57,107,0.348,,,,,,,,,,2010
994,Keith Smart,GSW,1,2,82,36,46,82,36,46,122,45,77,0.369,,,,,,,,,,2010
995,Rick Adelman,HOU,4,20,82,43,39,328,193,135,1561,945,616,0.605,,,,19.0,9.0,10.0,157.0,79.0,78.0,2010
996,Jim O'Brien,IND,4,9,44,17,27,290,121,169,630,303,327,0.48100000000000004,,,,,,,31.0,14.0,17.0,2010
997,Frank Vogel,IND,1,1,38,20,18,38,20,18,38,20,18,0.526,5.0,1.0,4.0,5.0,1.0,4.0,5.0,1.0,4.0,2010
998,Vinny Del Negro,LAC,1,3,82,32,50,82,32,50,246,114,132,0.46299999999999997,,,,,,,12.0,4.0,8.0,2010
999,Phil Jackson,LAL,11,20,82,57,25,902,610,292,1640,1155,485,0.7040000000000001,10.0,4.0,6.0,181.0,118.0,63.0,333.0,229.0,104.0,2010
1000,Lionel Hollins,MEM,5,5,82,46,36,267,117,150,267,117,150,0.43799999999999994,13.0,7.0,6.0,13.0,7.0,6.0,13.0,7.0,6.0,2010
1001,Erik Spoelstra,MIA,3,3,82,58,24,246,148,98,246,148,98,0.602,21.0,14.0,7.0,33.0,18.0,15.0,33.0,18.0,15.0,2010
1002,Scott Skiles,MIL,3,11,82,35,47,246,115,131,778,396,382,0.509,,,,7.0,3.0,4.0,42.0,18.0,24.0,2010
1003,Kurt Rambis,MIN,2,3,82,17,65,164,32,132,201,56,145,0.27899999999999997,,,,,,,8.0,3.0,5.0,2010
1004,Avery Johnson,NJN,1,5,82,24,58,82,24,58,346,218,128,0.63,,,,,,,47.0,23.0,24.0,2010
1005,Monty Williams,NOH,1,1,82,46,36,82,46,36,82,46,36,0.561,6.0,2.0,4.0,6.0,2.0,4.0,6.0,2.0,4.0,2010
1006,Mike D'Antoni,NYK,3,9,82,42,40,246,103,143,685,370,315,0.54,4.0,0.0,4.0,4.0,0.0,4.0,55.0,26.0,29.0,2010
1007,Scott Brooks,OKC,3,3,82,55,27,233,127,106,233,127,106,0.545,17.0,9.0,8.0,23.0,11.0,12.0,23.0,11.0,12.0,2010
1008,Stan Van Gundy,ORL,4,7,82,52,30,328,222,106,513,334,179,0.6509999999999999,6.0,2.0,4.0,54.0,30.0,24.0,82.0,47.0,35.0,2010
1009,Doug Collins,PHI,1,9,82,41,41,82,41,41,701,373,328,0.532,5.0,1.0,4.0,5.0,1.0,4.0,43.0,16.0,27.0,2010
1010,Alvin Gentry,PHO,3,10,82,40,42,195,112,83,598,289,309,0.483,,,,16.0,10.0,6.0,21.0,12.0,9.0,2010
1011,Nate McMillan,POR,6,11,82,48,34,492,246,246,887,458,429,0.516,6.0,2.0,4.0,18.0,6.0,12.0,34.0,14.0,20.0,2010
1012,Paul Westphal,SAC,2,9,82,24,58,164,49,115,590,316,274,0.536,,,,,,,49.0,27.0,22.0,2010
1013,Gregg Popovich,SAS,15,15,82,61,21,1180,797,383,1180,797,383,0.675,6.0,2.0,4.0,181.0,108.0,73.0,181.0,108.0,73.0,2010
1014,Jay Triano,TOR,3,3,82,22,60,229,87,142,229,87,142,0.38,,,,,,,,,,2010
1015,Jerry Sloan,UTA,23,26,54,31,23,1809,1127,682,2024,1221,803,0.603,,,,196.0,96.0,100.0,202.0,98.0,104.0,2010
1016,Tyrone Corbin,UTA,1,1,28,8,20,28,8,20,28,8,20,0.28600000000000003,,,,,,,,,,2010
1017,Flip Saunders,WAS,2,15,82,23,59,164,49,115,1147,636,511,0.5539999999999999,,,,,,,98.0,47.0,51.0,2010
1018,Mike Woodson,ATL,5,5,82,47,35,410,153,257,410,153,257,0.373,11.0,4.0,7.0,18.0,7.0,11.0,18.0,7.0,11.0,2008
1019,Doc Rivers,BOS,5,10,82,62,20,410,230,180,749,401,348,0.535,14.0,7.0,7.0,47.0,26.0,21.0,62.0,31.0,31.0,2008
1020,Larry Brown,CHA,1,28,82,35,47,82,35,47,2228,1274,954,0.5720000000000001,,,,,,,231.0,120.0,111.0,2008
1021,Vinny Del Negro,CHI,1,1,82,41,41,82,41,41,82,41,41,0.5,7.0,3.0,4.0,7.0,3.0,4.0,7.0,3.0,4.0,2008
1022,Mike Brown,CLE,4,4,82,66,16,328,211,117,328,211,117,0.643,14.0,10.0,4.0,60.0,36.0,24.0,60.0,36.0,24.0,2008
1023,Rick Carlisle,DAL,1,7,82,50,32,82,50,32,574,331,243,0.5770000000000001,10.0,5.0,5.0,10.0,5.0,5.0,72.0,35.0,37.0,2008
1024,George Karl,DEN,5,21,82,54,28,368,225,143,1575,933,642,0.5920000000000001,16.0,10.0,6.0,35.0,13.0,22.0,161.0,72.0,89.0,2008
1025,Michael Curry,DET,1,1,82,39,43,82,39,43,82,39,43,0.47600000000000003,4.0,0.0,4.0,4.0,0.0,4.0,4.0,0.0,4.0,2008
1026,Don Nelson,GSW,10,30,82,29,53,783,396,387,2316,1309,1007,0.565,,,,35.0,14.0,21.0,166.0,75.0,91.0,2008
1027,Rick Adelman,HOU,2,18,82,53,29,164,108,56,1397,860,537,0.616,13.0,7.0,6.0,19.0,9.0,10.0,157.0,79.0,78.0,2008
1028,Jim O'Brien,IND,2,7,82,36,46,164,72,92,504,254,250,0.504,,,,,,,31.0,14.0,17.0,2008
1029,Mike Dunleavy,LAC,6,16,82,19,63,492,194,298,1280,592,688,0.46299999999999997,,,,12.0,7.0,5.0,71.0,38.0,33.0,2008
1030,Phil Jackson,LAL,9,18,82,65,17,738,496,242,1476,1041,435,0.705,23.0,16.0,7.0,148.0,98.0,50.0,300.0,209.0,91.0,2008
1031,Marc Iavaroni,MEM,2,2,41,11,30,123,33,90,123,33,90,0.268,,,,,,,,,,2008
1032,Johnny Davis,MEM,1,4,2,0,2,2,0,2,219,73,146,0.33299999999999996,,,,,,,,,,2008
1033,Lionel Hollins,MEM,3,3,39,13,26,103,31,72,103,31,72,0.301,,,,,,,,,,2008
1034,Erik Spoelstra,MIA,1,1,82,43,39,82,43,39,82,43,39,0.524,7.0,3.0,4.0,7.0,3.0,4.0,7.0,3.0,4.0,2008
1035,Scott Skiles,MIL,1,9,82,34,48,82,34,48,614,315,299,0.513,,,,,,,35.0,15.0,20.0,2008
1036,Randy Wittman,MIN,3,5,19,4,15,143,38,105,307,100,207,0.326,,,,,,,,,,2008
1037,Kevin McHale,MIN,2,2,63,20,43,94,39,55,94,39,55,0.415,,,,,,,,,,2008
1038,Lawrence Frank,NJN,6,6,82,34,48,450,225,225,450,225,225,0.5,,,,38.0,18.0,20.0,38.0,18.0,20.0,2008
1039,Byron Scott,NOH,5,9,82,49,33,410,200,210,698,349,349,0.5,5.0,1.0,4.0,17.0,8.0,9.0,57.0,33.0,24.0,2008
1040,Mike D'Antoni,NYK,1,7,82,32,50,82,32,50,521,299,222,0.574,,,,,,,51.0,26.0,25.0,2008
1041,P.J. Carlesimo,OKC,2,8,13,1,12,95,21,74,500,204,296,0.408,,,,,,,12.0,3.0,9.0,2008
1042,Scott Brooks,OKC,1,1,69,22,47,69,22,47,69,22,47,0.319,,,,,,,,,,2008
1043,Stan Van Gundy,ORL,2,5,82,59,23,164,111,53,349,223,126,0.639,24.0,13.0,11.0,34.0,18.0,16.0,62.0,35.0,27.0,2008
1044,Maurice Cheeks,PHI,4,8,23,9,14,269,122,147,570,284,286,0.498,,,,6.0,2.0,4.0,16.0,5.0,11.0,2008
1045,Tony DiLeo,PHI,1,1,59,32,27,59,32,27,59,32,27,0.542,6.0,2.0,4.0,6.0,2.0,4.0,6.0,2.0,4.0,2008
1046,Terry Porter,PHO,1,3,51,28,23,51,28,23,215,99,116,0.46,,,,,,,5.0,1.0,4.0,2008
1047,Alvin Gentry,PHO,1,8,31,18,13,31,18,13,434,195,239,0.449,,,,,,,5.0,2.0,3.0,2008
1048,Nate McMillan,POR,4,9,82,54,28,328,148,180,723,360,363,0.498,6.0,2.0,4.0,6.0,2.0,4.0,22.0,10.0,12.0,2008
1049,Reggie Theus,SAC,2,2,24,6,18,106,44,62,106,44,62,0.415,,,,,,,,,,2008
1050,Kenny Natt,SAC,1,1,58,11,47,58,11,47,58,11,47,0.19,,,,,,,,,,2008
1051,Gregg Popovich,SAS,13,13,82,54,28,1016,686,330,1016,686,330,0.675,5.0,1.0,4.0,165.0,102.0,63.0,165.0,102.0,63.0,2008
1052,Sam Mitchell,TOR,5,5,17,8,9,345,156,189,345,156,189,0.452,,,,11.0,3.0,8.0,11.0,3.0,8.0,2008
1053,Jay Triano,TOR,1,1,65,25,40,65,25,40,65,25,40,0.385,,,,,,,,,,2008
1054,Jerry Sloan,UTA,21,24,82,48,34,1673,1043,630,1888,1137,751,0.602,5.0,1.0,4.0,186.0,92.0,94.0,192.0,94.0,98.0,2008
1055,Eddie Jordan,WAS,6,8,11,1,10,421,197,224,518,230,288,0.444,,,,26.0,8.0,18.0,26.0,8.0,18.0,2008
1056,Ed Tapscott,WAS,1,1,71,18,53,71,18,53,71,18,53,0.254,,,,,,,,,,2008
1057,Mike Farmer,BAL,1,1,9,1,8,9,1,8,9,1,8,0.111,,,,,,,,,,1966
1058,Buddy Jeannette,BAL,2,6,16,3,13,96,40,56,309,136,173,0.44,,,,10.0,5.0,5.0,24.0,14.0,10.0,1966
1059,Gene Shue,BAL,1,1,56,16,40,56,16,40,56,16,40,0.28600000000000003,,,,,,,,,,1966
1060,Bill Russell,BOS,1,1,81,60,21,81,60,21,81,60,21,0.741,9.0,4.0,5.0,9.0,4.0,5.0,9.0,4.0,5.0,1966
1061,Red Kerr,CHI,1,1,81,33,48,81,33,48,81,33,48,0.40700000000000003,3.0,0.0,3.0,3.0,0.0,3.0,3.0,0.0,3.0,1966
1062,Jack McMahon,CIN,4,5,81,39,42,321,187,134,359,199,160,0.5539999999999999,4.0,1.0,3.0,23.0,8.0,15.0,23.0,8.0,15.0,1966
1063,Dave DeBusschere,DET,3,3,73,28,45,222,79,143,222,79,143,0.35600000000000004,,,,,,,,,,1966
1064,Donnie Butcher,DET,1,1,8,2,6,8,2,6,8,2,6,0.25,,,,,,,,,,1966
1065,Fred Schaus,LAL,7,7,81,36,45,560,315,245,560,315,245,0.563,3.0,0.0,3.0,71.0,33.0,38.0,71.0,33.0,38.0,1966
1066,Dick McGuire,NYK,2,6,81,36,45,140,60,80,420,182,238,0.433,4.0,1.0,3.0,4.0,1.0,3.0,25.0,9.0,16.0,1966
1067,Alex Hannum,PHI,4,9,81,68,13,320,195,125,663,351,312,0.529,15.0,11.0,4.0,33.0,19.0,14.0,66.0,38.0,28.0,1966
1068,Bill Sharman,SFW,1,1,81,44,37,81,44,37,81,44,37,0.5429999999999999,15.0,9.0,6.0,15.0,9.0,6.0,15.0,9.0,6.0,1966
1069,Richie Guerin,STL,3,3,81,39,42,208,103,105,208,103,105,0.495,9.0,5.0,4.0,23.0,12.0,11.0,23.0,12.0,11.0,1966
1070,Lenny Wilkens,ATL,2,22,82,42,40,164,99,65,1782,968,814,0.5429999999999999,3.0,0.0,3.0,14.0,5.0,9.0,124.0,60.0,64.0,1994
1071,Chris Ford,BOS,5,5,82,35,47,410,222,188,410,222,188,0.541,4.0,1.0,3.0,29.0,13.0,16.0,29.0,13.0,16.0,1994
1072,Allan Bristow,CHH,4,4,82,50,32,328,166,162,328,166,162,0.506,4.0,1.0,3.0,13.0,5.0,8.0,13.0,5.0,8.0,1994
1073,Phil Jackson,CHI,6,6,82,47,35,492,342,150,492,342,150,0.695,10.0,5.0,5.0,94.0,66.0,28.0,94.0,66.0,28.0,1994
1074,Mike Fratello,CLE,2,10,82,43,39,164,90,74,741,414,327,0.5589999999999999,4.0,1.0,3.0,7.0,1.0,6.0,47.0,19.0,28.0,1994
1075,Dick Motta,DAL,8,23,82,36,46,656,303,353,1801,892,909,0.495,,,,28.0,11.0,17.0,126.0,56.0,70.0,1994
1076,Dan Issel,DEN,3,3,34,18,16,198,96,102,198,96,102,0.485,,,,12.0,6.0,6.0,12.0,6.0,6.0,1994
1077,Gene Littles,DEN,1,4,16,3,13,16,3,13,155,44,111,0.284,,,,,,,,,,1994
1078,Bernie Bickerstaff,DEN,1,6,32,20,12,32,20,12,442,222,220,0.502,3.0,0.0,3.0,3.0,0.0,3.0,30.0,12.0,18.0,1994
1079,Don Chaney,DET,2,9,82,28,54,164,48,116,647,265,382,0.41,,,,,,,11.0,2.0,9.0,1994
1080,Don Nelson,GSW,7,18,45,14,31,537,277,260,1421,817,604,0.575,,,,24.0,9.0,15.0,112.0,51.0,61.0,1994
1081,Bob Lanier,GSW,1,1,37,12,25,37,12,25,37,12,25,0.324,,,,,,,,,,1994
1082,Rudy Tomjanovich,HOU,4,4,82,47,35,276,176,100,276,176,100,0.638,22.0,15.0,7.0,57.0,36.0,21.0,57.0,36.0,21.0,1994
1083,Larry Brown,IND,2,16,82,52,30,164,99,65,1276,762,514,0.597,17.0,10.0,7.0,33.0,20.0,13.0,120.0,59.0,61.0,1994
1084,Bill Fitch,LAC,1,22,82,17,65,82,17,65,1804,862,942,0.478,,,,,,,106.0,55.0,51.0,1994
1085,Del Harris,LAL,1,10,82,48,34,82,48,34,755,380,375,0.503,10.0,5.0,5.0,10.0,5.0,5.0,62.0,26.0,36.0,1994
1086,Kevin Loughery,MIA,4,20,46,17,29,292,133,159,1388,642,746,0.46299999999999997,,,,8.0,2.0,6.0,59.0,27.0,32.0,1994
1087,Alvin Gentry,MIA,1,1,36,15,21,36,15,21,36,15,21,0.41700000000000004,,,,,,,,,,1994
1088,Mike Dunleavy,MIL,3,5,82,34,48,246,82,164,410,183,227,0.446,,,,,,,23.0,13.0,10.0,1994
1089,Bill Blair,MIN,1,2,82,21,61,82,21,61,88,23,65,0.261,,,,,,,2.0,0.0,2.0,1994
1090,Butch Beard,NJN,1,1,82,30,52,82,30,52,82,30,52,0.366,,,,,,,,,,1994
1091,Pat Riley,NYK,4,13,82,55,27,328,223,105,1055,756,299,0.7170000000000001,11.0,6.0,5.0,63.0,35.0,28.0,212.0,137.0,75.0,1994
1092,Brian Hill,ORL,2,2,82,57,25,164,107,57,164,107,57,0.652,21.0,11.0,10.0,24.0,11.0,13.0,24.0,11.0,13.0,1994
1093,John Lucas,PHI,1,3,82,24,58,82,24,58,225,118,107,0.524,,,,,,,14.0,6.0,8.0,1994
1094,Paul Westphal,PHO,3,3,82,59,23,246,177,69,246,177,69,0.72,10.0,6.0,4.0,44.0,25.0,19.0,44.0,25.0,19.0,1994
1095,P.J. Carlesimo,POR,1,1,82,44,38,82,44,38,82,44,38,0.537,3.0,0.0,3.0,3.0,0.0,3.0,3.0,0.0,3.0,1994
1096,Garry St. Jean,SAC,3,3,82,39,43,246,92,154,246,92,154,0.374,,,,,,,,,,1994
1097,Bob Hill,SAS,1,5,82,62,20,82,62,20,369,195,174,0.528,15.0,9.0,6.0,15.0,9.0,6.0,27.0,12.0,15.0,1994
1098,George Karl,SEA,4,8,82,57,25,288,202,86,583,321,262,0.551,4.0,1.0,3.0,37.0,17.0,20.0,51.0,22.0,29.0,1994
1099,Jerry Sloan,UTA,7,10,82,60,22,557,364,193,772,458,314,0.593,5.0,2.0,3.0,59.0,27.0,32.0,65.0,29.0,36.0,1994
1100,Jim Lynam,WSB,1,8,82,21,61,82,21,61,592,267,325,0.451,,,,,,,21.0,8.0,13.0,1994
1101,Mike Woodson,ATL,3,3,82,30,52,246,69,177,246,69,177,0.28,,,,,,,,,,2006
1102,Doc Rivers,BOS,3,8,82,24,58,246,102,144,585,273,312,0.467,,,,7.0,3.0,4.0,22.0,8.0,14.0,2006
1103,Bernie Bickerstaff,CHA,3,13,82,33,49,246,77,169,932,415,517,0.445,,,,,,,33.0,12.0,21.0,2006
1104,Scott Skiles,CHI,4,7,82,49,33,312,156,156,507,272,235,0.536,10.0,6.0,4.0,22.0,10.0,12.0,35.0,15.0,20.0,2006
1105,Mike Brown,CLE,2,2,82,50,32,164,100,64,164,100,64,0.61,20.0,12.0,8.0,33.0,19.0,14.0,33.0,19.0,14.0,2006
1106,Avery Johnson,DAL,3,3,82,67,15,182,143,39,182,143,39,0.7859999999999999,6.0,2.0,4.0,42.0,22.0,20.0,42.0,22.0,20.0,2006
1107,George Karl,DEN,3,19,82,45,37,204,121,83,1411,829,582,0.588,5.0,1.0,4.0,15.0,3.0,12.0,141.0,62.0,79.0,2006
1108,Flip Saunders,DET,2,12,82,53,29,164,117,47,901,528,373,0.586,16.0,10.0,6.0,34.0,20.0,14.0,81.0,37.0,44.0,2006
1109,Don Nelson,GSW,8,28,82,42,40,619,319,300,2152,1232,920,0.5720000000000001,11.0,5.0,6.0,35.0,14.0,21.0,166.0,75.0,91.0,2006
1110,Jeff Van Gundy,HOU,4,11,82,52,30,328,182,146,748,430,318,0.575,7.0,3.0,4.0,19.0,7.0,12.0,88.0,44.0,44.0,2006
1111,Rick Carlisle,IND,4,6,82,35,47,328,181,147,492,281,211,0.5710000000000001,,,,35.0,18.0,17.0,62.0,30.0,32.0,2006
1112,Mike Dunleavy,LAC,4,14,82,40,42,328,152,176,1116,550,566,0.493,,,,12.0,7.0,5.0,71.0,38.0,33.0,2006
1113,Phil Jackson,LAL,7,16,82,42,40,574,374,200,1312,919,393,0.7,5.0,1.0,4.0,104.0,68.0,36.0,256.0,179.0,77.0,2006
1114,Mike Fratello,MEM,3,17,30,6,24,178,95,83,1215,667,548,0.5489999999999999,,,,8.0,0.0,8.0,62.0,20.0,42.0,2006
1115,Tony Barone,MEM,1,1,52,16,36,52,16,36,52,16,36,0.308,,,,,,,,,,2006
1116,Pat Riley,MIA,10,23,82,44,38,767,439,328,1822,1195,627,0.6559999999999999,4.0,0.0,4.0,70.0,34.0,36.0,282.0,171.0,111.0,2006
1117,Terry Stotts,MIL,2,4,64,23,41,146,63,83,283,115,168,0.406,,,,5.0,1.0,4.0,5.0,1.0,4.0,2006
1118,Larry Krystkowiak,MIL,1,1,18,5,13,18,5,13,18,5,13,0.278,,,,,,,,,,2006
1119,Dwane Casey,MIN,2,2,40,20,20,122,53,69,122,53,69,0.434,,,,,,,,,,2006
1120,Randy Wittman,MIN,1,3,42,12,30,42,12,30,206,74,132,0.359,,,,,,,,,,2006
1121,Lawrence Frank,NJN,4,4,82,41,41,286,157,129,286,157,129,0.5489999999999999,12.0,6.0,6.0,38.0,18.0,20.0,38.0,18.0,20.0,2006
1122,Byron Scott,NOK,3,7,82,39,43,246,95,151,534,244,290,0.457,,,,,,,40.0,25.0,15.0,2006
1123,Isiah Thomas,NYK,1,4,82,33,49,82,33,49,328,164,164,0.5,,,,,,,15.0,5.0,10.0,2006
1124,Brian Hill,ORL,6,9,82,40,42,459,267,192,613,298,315,0.486,4.0,0.0,4.0,40.0,18.0,22.0,40.0,18.0,22.0,2006
1125,Maurice Cheeks,PHI,2,6,82,35,47,164,73,91,465,235,230,0.505,,,,,,,10.0,3.0,7.0,2006
1126,Mike D'Antoni,PHO,4,5,82,61,21,307,198,109,357,212,145,0.594,11.0,6.0,5.0,46.0,25.0,21.0,46.0,25.0,21.0,2006
1127,Nate McMillan,POR,2,7,82,32,50,164,53,111,559,265,294,0.474,,,,,,,16.0,8.0,8.0,2006
1128,Eric Musselman,SAC,1,3,82,33,49,82,33,49,246,108,138,0.439,,,,,,,,,,2006
1129,Gregg Popovich,SAS,11,11,82,58,24,852,576,276,852,576,276,0.6759999999999999,20.0,16.0,4.0,143.0,92.0,51.0,143.0,92.0,51.0,2006
1130,Bob Hill,SEA,2,9,82,31,51,134,53,81,603,310,293,0.514,,,,,,,37.0,17.0,20.0,2006
1131,Sam Mitchell,TOR,3,3,82,47,35,246,107,139,246,107,139,0.435,6.0,2.0,4.0,6.0,2.0,4.0,6.0,2.0,4.0,2006
1132,Jerry Sloan,UTA,19,22,82,51,31,1509,941,568,1724,1035,689,0.6,17.0,9.0,8.0,169.0,85.0,84.0,175.0,87.0,88.0,2006
1133,Eddie Jordan,WAS,4,6,82,41,41,328,153,175,425,186,239,0.43799999999999994,4.0,0.0,4.0,20.0,6.0,14.0,20.0,6.0,14.0,2006
1134,Richie Guerin,ATL,8,8,82,36,46,618,327,291,618,327,291,0.529,6.0,2.0,4.0,60.0,26.0,34.0,60.0,26.0,34.0,1971
1135,Gene Shue,BAL,6,6,82,38,44,466,239,227,466,239,227,0.513,6.0,2.0,4.0,35.0,13.0,22.0,35.0,13.0,22.0,1971
1136,Tom Heinsohn,BOS,3,3,82,56,26,246,134,112,246,134,112,0.545,11.0,5.0,6.0,11.0,5.0,6.0,11.0,5.0,6.0,1971
1137,Dolph Schayes,BUF,2,5,1,0,1,83,22,61,323,151,172,0.467,,,,,,,21.0,9.0,12.0,1971
1138,Johnny McCarthy,BUF,1,1,81,22,59,81,22,59,81,22,59,0.272,,,,,,,,,,1971
1139,Dick Motta,CHI,4,4,82,57,25,328,180,148,328,180,148,0.5489999999999999,4.0,0.0,4.0,16.0,4.0,12.0,16.0,4.0,12.0,1971
1140,Bob Cousy,CIN,3,3,82,30,52,246,99,147,246,99,147,0.402,,,,,,,,,,1971
1141,Bill Fitch,CLE,2,2,82,23,59,164,38,126,164,38,126,0.23199999999999998,,,,,,,,,,1971
1142,Butch van Breda Kolff,DET,3,5,10,6,4,174,82,92,338,189,149,0.5589999999999999,,,,,,,33.0,21.0,12.0,1971
1143,Terry Dischinger,DET,1,1,2,0,2,2,0,2,2,0,2,0.0,,,,,,,,,,1971
1144,Earl Lloyd,DET,1,1,70,20,50,70,20,50,70,20,50,0.28600000000000003,,,,,,,,,,1971
1145,Al Attles,GSW,3,3,82,51,31,194,100,94,194,100,94,0.515,5.0,1.0,4.0,10.0,2.0,8.0,10.0,2.0,8.0,1971
1146,Tex Winter,HOU,1,1,82,34,48,82,34,48,82,34,48,0.415,,,,,,,,,,1971
1147,Bill Sharman,LAL,1,6,82,69,13,82,69,13,491,289,202,0.589,15.0,12.0,3.0,15.0,12.0,3.0,75.0,47.0,28.0,1971
1148,Larry Costello,MIL,4,4,82,63,19,328,212,116,328,212,116,0.6459999999999999,11.0,6.0,5.0,35.0,23.0,12.0,35.0,23.0,12.0,1971
1149,Red Holzman,NYK,5,9,82,48,34,372,242,130,575,325,250,0.565,16.0,9.0,7.0,63.0,36.0,27.0,71.0,40.0,31.0,1971
1150,Jack Ramsay,PHI,4,4,82,30,52,328,174,154,328,174,154,0.53,,,,17.0,5.0,12.0,17.0,5.0,12.0,1971
1151,Cotton Fitzsimmons,PHO,2,2,82,49,33,164,97,67,164,97,67,0.591,,,,,,,,,,1971
1152,Rolland Todd,POR,2,2,56,12,44,138,41,97,138,41,97,0.297,,,,,,,,,,1971
1153,Stu Inman,POR,1,1,26,6,20,26,6,20,26,6,20,0.231,,,,,,,,,,1971
1154,Lenny Wilkens,SEA,3,3,82,47,35,246,121,125,246,121,125,0.49200000000000005,,,,,,,,,,1971
1155,Mike Budenholzer,ATL,1,1,82,38,44,82,38,44,82,38,44,0.46299999999999997,7.0,3.0,4.0,7.0,3.0,4.0,7.0,3.0,4.0,2013
1156,Brad Stevens,BOS,1,1,82,25,57,82,25,57,82,25,57,0.305,,,,,,,,,,2013
1157,Jason Kidd,BRK,1,1,82,44,38,82,44,38,82,44,38,0.537,12.0,5.0,7.0,12.0,5.0,7.0,12.0,5.0,7.0,2013
1158,Steve Clifford,CHA,1,1,82,43,39,82,43,39,82,43,39,0.524,4.0,0.0,4.0,4.0,0.0,4.0,4.0,0.0,4.0,2013
1159,Tom Thibodeau,CHI,4,4,82,48,34,312,205,107,312,205,107,0.657,5.0,1.0,4.0,39.0,17.0,22.0,39.0,17.0,22.0,2013
1160,Mike Brown,CLE,6,8,82,33,49,492,305,187,563,347,216,0.616,,,,71.0,42.0,29.0,83.0,47.0,36.0,2013
1161,Rick Carlisle,DAL,6,12,82,49,33,476,288,188,968,569,399,0.588,7.0,3.0,4.0,48.0,26.0,22.0,110.0,56.0,54.0,2013
1162,Brian Shaw,DEN,1,1,82,36,46,82,36,46,82,36,46,0.439,,,,,,,,,,2013
1163,Maurice Cheeks,DET,1,9,50,21,29,50,21,29,620,305,315,0.49200000000000005,,,,,,,16.0,5.0,11.0,2013
1164,John Loyer,DET,1,1,32,8,24,32,8,24,32,8,24,0.25,,,,,,,,,,2013
1165,Mark Jackson,GSW,3,3,82,51,31,230,121,109,230,121,109,0.526,7.0,3.0,4.0,19.0,9.0,10.0,19.0,9.0,10.0,2013
1166,Kevin McHale,HOU,3,5,82,54,28,230,133,97,324,172,152,0.531,6.0,2.0,4.0,12.0,4.0,8.0,12.0,4.0,8.0,2013
1167,Frank Vogel,IND,4,4,82,56,26,267,167,100,267,167,100,0.625,19.0,10.0,9.0,54.0,28.0,26.0,54.0,28.0,26.0,2013
1168,Doc Rivers,LAC,1,15,82,57,25,82,57,25,1142,644,498,0.564,13.0,6.0,7.0,13.0,6.0,7.0,134.0,70.0,64.0,2013
1169,Mike D'Antoni,LAL,2,12,82,27,55,154,67,87,881,455,426,0.516,,,,4.0,0.0,4.0,59.0,26.0,33.0,2013
1170,Dave Joerger,MEM,1,1,82,50,32,82,50,32,82,50,32,0.61,7.0,3.0,4.0,7.0,3.0,4.0,7.0,3.0,4.0,2013
1171,Erik Spoelstra,MIA,6,6,82,54,28,476,314,162,476,314,162,0.66,20.0,13.0,7.0,99.0,63.0,36.0,99.0,63.0,36.0,2013
1172,Larry Drew,MIL,1,4,82,15,67,82,15,67,312,143,169,0.45799999999999996,,,,,,,24.0,10.0,14.0,2013
1173,Rick Adelman,MIN,3,23,82,40,42,230,97,133,1791,1042,749,0.5820000000000001,,,,,,,157.0,79.0,78.0,2013
1174,Monty Williams,NOP,4,4,82,34,48,312,128,184,312,128,184,0.41,,,,6.0,2.0,4.0,6.0,2.0,4.0,2013
1175,Mike Woodson,NYK,3,9,82,37,45,188,109,79,680,315,365,0.46299999999999997,,,,17.0,7.0,10.0,46.0,18.0,28.0,2013
1176,Scott Brooks,OKC,6,6,82,59,23,463,293,170,463,293,170,0.633,19.0,10.0,9.0,73.0,39.0,34.0,73.0,39.0,34.0,2013
1177,Jacque Vaughn,ORL,2,2,82,23,59,164,43,121,164,43,121,0.262,,,,,,,,,,2013
1178,Brett Brown,PHI,1,1,82,19,63,82,19,63,82,19,63,0.23199999999999998,,,,,,,,,,2013
1179,Jeff Hornacek,PHO,1,1,82,48,34,82,48,34,82,48,34,0.585,,,,,,,,,,2013
1180,Terry Stotts,POR,2,6,82,54,28,164,87,77,447,202,245,0.452,11.0,5.0,6.0,11.0,5.0,6.0,16.0,6.0,10.0,2013
1181,Mike Malone,SAC,1,1,82,28,54,82,28,54,82,28,54,0.341,,,,,,,,,,2013
1182,Gregg Popovich,SAS,18,18,82,62,20,1410,967,443,1410,967,443,0.6859999999999999,23.0,16.0,7.0,239.0,149.0,90.0,239.0,149.0,90.0,2013
1183,Dwane Casey,TOR,3,5,82,48,34,230,105,125,352,158,194,0.449,7.0,3.0,4.0,7.0,3.0,4.0,7.0,3.0,4.0,2013
1184,Tyrone Corbin,UTA,4,4,82,25,57,258,112,146,258,112,146,0.434,,,,4.0,0.0,4.0,4.0,0.0,4.0,2013
1185,Randy Wittman,WAS,3,8,82,44,38,213,91,122,520,191,329,0.36700000000000005,11.0,6.0,5.0,11.0,6.0,5.0,11.0,6.0,5.0,2013
1186,Mike Woodson,ATL,1,1,82,13,69,82,13,69,82,13,69,0.159,,,,,,,,,,2004
1187,Doc Rivers,BOS,1,6,82,45,37,82,45,37,421,216,205,0.513,7.0,3.0,4.0,7.0,3.0,4.0,22.0,8.0,14.0,2004
1188,Bernie Bickerstaff,CHA,1,11,82,18,64,82,18,64,768,356,412,0.46399999999999997,,,,,,,33.0,12.0,21.0,2004
1189,Scott Skiles,CHI,2,5,82,47,35,148,66,82,343,182,161,0.531,6.0,2.0,4.0,6.0,2.0,4.0,19.0,7.0,12.0,2004
1190,Paul Silas,CLE,2,10,64,34,30,146,69,77,755,355,400,0.47,,,,,,,29.0,13.0,16.0,2004
1191,Brendan Malone,CLE,1,2,18,8,10,18,8,10,100,29,71,0.29,,,,,,,,,,2004
1192,Don Nelson,DAL,8,27,64,42,22,590,339,251,2070,1190,880,0.575,,,,43.0,19.0,24.0,155.0,70.0,85.0,2004
1193,Avery Johnson,DAL,1,1,18,16,2,18,16,2,18,16,2,0.889,13.0,6.0,7.0,13.0,6.0,7.0,13.0,6.0,7.0,2004
1194,Jeff Bzdelik,DEN,3,3,28,13,15,192,73,119,192,73,119,0.38,,,,5.0,1.0,4.0,5.0,1.0,4.0,2004
1195,Michael Cooper,DEN,1,1,14,4,10,14,4,10,14,4,10,0.28600000000000003,,,,,,,,,,2004
1196,George Karl,DEN,1,17,40,32,8,40,32,8,1247,740,507,0.593,5.0,1.0,4.0,5.0,1.0,4.0,131.0,60.0,71.0,2004
1197,Larry Brown,DET,2,26,82,54,28,164,108,56,2064,1216,848,0.589,25.0,15.0,10.0,48.0,31.0,17.0,231.0,120.0,111.0,2004
1198,Mike Montgomery,GSW,1,1,82,34,48,82,34,48,82,34,48,0.415,,,,,,,,,,2004
1199,Jeff Van Gundy,HOU,2,9,82,51,31,164,96,68,584,344,240,0.589,7.0,3.0,4.0,12.0,4.0,8.0,81.0,41.0,40.0,2004
1200,Rick Carlisle,IND,2,4,82,44,38,164,105,59,328,205,123,0.625,13.0,6.0,7.0,29.0,16.0,13.0,56.0,28.0,28.0,2004
1201,Mike Dunleavy,LAC,2,12,82,37,45,164,65,99,952,463,489,0.486,,,,,,,59.0,31.0,28.0,2004
1202,Rudy Tomjanovich,LAL,1,13,43,24,19,43,24,19,943,527,416,0.5589999999999999,,,,,,,90.0,51.0,39.0,2004
1203,Frank Hamblen,LAL,1,2,39,10,29,39,10,29,104,33,71,0.317,,,,,,,,,,2004
1204,Hubie Brown,MEM,3,15,12,5,7,168,83,85,1087,528,559,0.486,,,,4.0,0.0,4.0,63.0,31.0,32.0,2004
1205,Lionel Hollins,MEM,2,2,4,0,4,64,18,46,64,18,46,0.281,,,,,,,,,,2004
1206,Mike Fratello,MEM,1,15,66,40,26,66,40,26,1103,612,491,0.555,4.0,0.0,4.0,4.0,0.0,4.0,58.0,20.0,38.0,2004
1207,Stan Van Gundy,MIA,2,2,82,59,23,164,101,63,164,101,63,0.616,15.0,11.0,4.0,28.0,17.0,11.0,28.0,17.0,11.0,2004
1208,Terry Porter,MIL,2,2,82,30,52,164,71,93,164,71,93,0.433,,,,5.0,1.0,4.0,5.0,1.0,4.0,2004
1209,Flip Saunders,MIN,10,10,51,25,26,737,411,326,737,411,326,0.5579999999999999,,,,47.0,17.0,30.0,47.0,17.0,30.0,2004
1210,Kevin McHale,MIN,1,1,31,19,12,31,19,12,31,19,12,0.613,,,,,,,,,,2004
1211,Lawrence Frank,NJN,2,2,82,42,40,122,67,55,122,67,55,0.5489999999999999,4.0,0.0,4.0,15.0,7.0,8.0,15.0,7.0,8.0,2004
1212,Byron Scott,NOH,1,5,82,18,64,82,18,64,370,167,203,0.451,,,,,,,40.0,25.0,15.0,2004
1213,Lenny Wilkens,NYK,2,32,39,17,22,81,40,41,2487,1332,1155,0.536,,,,4.0,0.0,4.0,178.0,80.0,98.0,2004
1214,Herb Williams,NYK,2,2,43,16,27,44,17,27,44,17,27,0.386,,,,,,,,,,2004
1215,Johnny Davis,ORL,2,3,64,31,33,135,51,84,217,73,144,0.336,,,,,,,,,,2004
1216,Chris Jent,ORL,1,1,18,5,13,18,5,13,18,5,13,0.278,,,,,,,,,,2004
1217,Jim O'Brien,PHI,1,5,82,43,39,82,43,39,340,182,158,0.535,5.0,1.0,4.0,5.0,1.0,4.0,31.0,14.0,17.0,2004
1218,Mike D'Antoni,PHO,2,3,82,62,20,143,83,60,193,97,96,0.503,15.0,9.0,6.0,15.0,9.0,6.0,15.0,9.0,6.0,2004
1219,Maurice Cheeks,POR,4,4,55,22,33,301,162,139,301,162,139,0.5379999999999999,,,,10.0,3.0,7.0,10.0,3.0,7.0,2004
1220,Kevin Pritchard,POR,1,1,27,5,22,27,5,22,27,5,22,0.185,,,,,,,,,,2004
1221,Rick Adelman,SAC,7,15,82,50,32,542,351,191,1151,708,443,0.615,5.0,1.0,4.0,63.0,32.0,31.0,132.0,68.0,64.0,2004
1222,Gregg Popovich,SAS,9,9,82,59,23,688,455,233,688,455,233,0.6609999999999999,23.0,16.0,7.0,110.0,69.0,41.0,110.0,69.0,41.0,2004
1223,Nate McMillan,SEA,5,5,82,52,30,395,212,183,395,212,183,0.537,11.0,6.0,5.0,16.0,8.0,8.0,16.0,8.0,8.0,2004
1224,Sam Mitchell,TOR,1,1,82,33,49,82,33,49,82,33,49,0.402,,,,,,,,,,2004
1225,Jerry Sloan,UTA,17,20,82,26,56,1345,849,496,1560,943,617,0.604,,,,152.0,76.0,76.0,158.0,78.0,80.0,2004
1226,Eddie Jordan,WAS,2,4,82,45,37,164,70,94,261,103,158,0.395,10.0,4.0,6.0,10.0,4.0,6.0,10.0,4.0,6.0,2004
1227,Lon Kruger,ATL,1,1,82,25,57,82,25,57,82,25,57,0.305,,,,,,,,,,2000
1228,Rick Pitino,BOS,4,6,34,12,22,248,102,146,412,192,220,0.466,,,,,,,13.0,6.0,7.0,2000
1229,Jim O'Brien,BOS,1,1,48,24,24,48,24,24,48,24,24,0.5,,,,,,,,,,2000
1230,Paul Silas,CHH,3,6,82,46,36,199,117,82,445,195,250,0.43799999999999994,10.0,6.0,4.0,14.0,7.0,7.0,14.0,7.0,7.0,2000
1231,Tim Floyd,CHI,3,3,82,15,67,214,45,169,214,45,169,0.21,,,,,,,,,,2000
1232,Randy Wittman,CLE,2,2,82,30,52,164,62,102,164,62,102,0.37799999999999995,,,,,,,,,,2000
1233,Don Nelson,DAL,4,23,82,53,29,280,128,152,1760,979,781,0.556,10.0,4.0,6.0,10.0,4.0,6.0,122.0,55.0,67.0,2000
1234,Dan Issel,DEN,5,5,82,40,42,362,171,191,362,171,191,0.47200000000000003,,,,12.0,6.0,6.0,12.0,6.0,6.0,2000
1235,George Irvine,DET,2,5,82,32,50,106,46,60,290,100,190,0.345,,,,3.0,0.0,3.0,3.0,0.0,3.0,2000
1236,Dave Cowens,GSW,1,5,82,17,65,82,17,65,329,153,176,0.465,,,,,,,12.0,4.0,8.0,2000
1237,Rudy Tomjanovich,HOU,10,10,82,45,37,736,432,304,736,432,304,0.5870000000000001,,,,90.0,51.0,39.0,90.0,51.0,39.0,2000
1238,Isiah Thomas,IND,1,1,82,41,41,82,41,41,82,41,41,0.5,4.0,1.0,3.0,4.0,1.0,3.0,4.0,1.0,3.0,2000
1239,Alvin Gentry,LAC,1,5,82,31,51,82,31,51,263,119,144,0.452,,,,,,,5.0,2.0,3.0,2000
1240,Phil Jackson,LAL,2,11,82,56,26,164,123,41,902,668,234,0.741,16.0,15.0,1.0,39.0,30.0,9.0,191.0,141.0,50.0,2000
1241,Pat Riley,MIA,6,19,82,50,32,460,293,167,1515,1049,466,0.6920000000000001,3.0,0.0,3.0,43.0,18.0,25.0,255.0,155.0,100.0,2000
1242,George Karl,MIL,3,14,82,52,30,214,122,92,1043,625,418,0.599,18.0,10.0,8.0,26.0,12.0,14.0,120.0,57.0,63.0,2000
1243,Flip Saunders,MIN,6,6,82,47,35,440,227,213,440,227,213,0.516,4.0,1.0,3.0,20.0,5.0,15.0,20.0,5.0,15.0,2000
1244,Byron Scott,NJN,1,1,82,26,56,82,26,56,82,26,56,0.317,,,,,,,,,,2000
1245,Jeff Van Gundy,NYK,6,6,82,48,34,401,238,163,401,238,163,0.594,5.0,2.0,3.0,69.0,37.0,32.0,69.0,37.0,32.0,2000
1246,Doc Rivers,ORL,2,2,82,43,39,164,84,80,164,84,80,0.512,4.0,1.0,3.0,4.0,1.0,3.0,4.0,1.0,3.0,2000
1247,Larry Brown,PHI,4,22,82,56,26,296,164,132,1736,1017,719,0.586,23.0,12.0,11.0,41.0,20.0,21.0,166.0,81.0,85.0,2000
1248,Scott Skiles,PHO,2,2,82,51,31,144,91,53,144,91,53,0.632,4.0,1.0,3.0,13.0,5.0,8.0,13.0,5.0,8.0,2000
1249,Mike Dunleavy,POR,4,10,82,50,32,296,190,106,788,398,390,0.505,3.0,0.0,3.0,36.0,18.0,18.0,59.0,31.0,28.0,2000
1250,Rick Adelman,SAC,3,11,82,55,27,214,126,88,823,483,340,0.5870000000000001,8.0,3.0,5.0,18.0,7.0,11.0,87.0,43.0,44.0,2000
1251,Gregg Popovich,SAS,5,5,82,58,24,360,221,139,360,221,139,0.614,13.0,7.0,6.0,43.0,27.0,16.0,43.0,27.0,16.0,2000
1252,Paul Westphal,SEA,3,7,15,6,9,147,76,71,426,267,159,0.627,,,,5.0,2.0,3.0,49.0,27.0,22.0,2000
1253,Nate McMillan,SEA,1,1,67,38,29,67,38,29,67,38,29,0.5670000000000001,,,,,,,,,,2000
1254,Lenny Wilkens,TOR,1,28,82,47,35,82,47,35,2242,1226,1016,0.547,12.0,6.0,6.0,12.0,6.0,6.0,169.0,78.0,91.0,2000
1255,Jerry Sloan,UTA,13,16,82,53,29,1017,690,327,1232,784,448,0.636,5.0,2.0,3.0,143.0,74.0,69.0,149.0,76.0,73.0,2000
1256,Sidney Lowe,VAN,1,3,82,23,59,82,23,59,217,56,161,0.258,,,,,,,,,,2000
1257,Leonard Hamilton,WAS,1,1,82,19,63,82,19,63,82,19,63,0.23199999999999998,,,,,,,,,,2000
1258,Red Auerbach,BOS,11,15,79,57,22,792,502,290,1017,645,372,0.634,10.0,8.0,2.0,82.0,47.0,35.0,102.0,56.0,46.0,1960
1259,Charles Wolf,CIN,1,1,79,33,46,79,33,46,79,33,46,0.418,,,,,,,,,,1960
1260,Dick McGuire,DET,2,2,79,34,45,120,51,69,120,51,69,0.425,5.0,2.0,3.0,7.0,2.0,5.0,7.0,2.0,5.0,1960
1261,Fred Schaus,LAL,1,1,79,36,43,79,36,43,79,36,43,0.456,12.0,6.0,6.0,12.0,6.0,6.0,12.0,6.0,6.0,1960
1262,Carl Braun,NYK,2,2,79,21,58,127,40,87,127,40,87,0.315,,,,,,,,,,1960
1263,Neil Johnston,PHW,2,2,79,46,33,154,95,59,154,95,59,0.617,3.0,0.0,3.0,12.0,4.0,8.0,12.0,4.0,8.0,1960
1264,Paul Seymour,STL,1,5,79,51,28,79,51,28,358,206,152,0.575,12.0,5.0,7.0,12.0,5.0,7.0,32.0,14.0,18.0,1960
1265,Alex Hannum,SYR,1,3,79,38,41,79,38,41,182,94,88,0.516,8.0,4.0,4.0,8.0,4.0,4.0,29.0,18.0,11.0,1960
1266,Mike Fratello,ATL,7,7,82,52,30,495,283,212,495,283,212,0.5720000000000001,5.0,2.0,3.0,40.0,18.0,22.0,40.0,18.0,22.0,1988
1267,Jimmy Rodgers,BOS,1,1,82,42,40,82,42,40,82,42,40,0.512,3.0,0.0,3.0,3.0,0.0,3.0,3.0,0.0,3.0,1988
1268,Dick Harter,CHH,1,1,82,20,62,82,20,62,82,20,62,0.244,,,,,,,,,,1988
1269,Doug Collins,CHI,3,3,82,47,35,246,137,109,246,137,109,0.557,17.0,9.0,8.0,30.0,13.0,17.0,30.0,13.0,17.0,1988
1270,Lenny Wilkens,CLE,3,16,82,57,25,246,130,116,1290,683,607,0.529,5.0,2.0,3.0,10.0,4.0,6.0,79.0,41.0,38.0,1988
1271,John MacLeod,DAL,2,16,82,38,44,164,91,73,1286,670,616,0.521,,,,17.0,10.0,7.0,98.0,47.0,51.0,1988
1272,Doug Moe,DEN,9,13,82,44,38,707,389,318,1019,566,453,0.555,3.0,0.0,3.0,58.0,24.0,34.0,80.0,33.0,47.0,1988
1273,Chuck Daly,DET,6,7,82,63,19,492,310,182,533,319,214,0.598,17.0,15.0,2.0,73.0,47.0,26.0,73.0,47.0,26.0,1988
1274,Don Nelson,GSW,1,12,82,43,39,82,43,39,966,583,383,0.604,8.0,4.0,4.0,8.0,4.0,4.0,96.0,46.0,50.0,1988
1275,Don Chaney,HOU,1,4,82,45,37,82,45,37,267,98,169,0.36700000000000005,4.0,1.0,3.0,4.0,1.0,3.0,4.0,1.0,3.0,1988
1276,Jack Ramsay,IND,3,21,7,0,7,171,79,92,1647,864,783,0.525,,,,4.0,1.0,3.0,102.0,44.0,58.0,1988
1277,Mel Daniels,IND,1,1,2,0,2,2,0,2,2,0,2,0.0,,,,,,,,,,1988
1278,George Irvine,IND,3,3,20,6,14,184,54,130,184,54,130,0.293,,,,,,,,,,1988
1279,Dick Versace,IND,1,1,53,22,31,53,22,31,53,22,31,0.415,,,,,,,,,,1988
1280,Gene Shue,LAC,4,22,38,10,28,284,105,179,1645,784,861,0.47700000000000004,,,,,,,77.0,30.0,47.0,1988
1281,Don Casey,LAC,1,1,44,11,33,44,11,33,44,11,33,0.25,,,,,,,,,,1988
1282,Pat Riley,LAL,8,8,82,57,25,645,470,175,645,470,175,0.7290000000000001,15.0,11.0,4.0,140.0,98.0,42.0,140.0,98.0,42.0,1988
1283,Ron Rothstein,MIA,1,1,82,15,67,82,15,67,82,15,67,0.183,,,,,,,,,,1988
1284,Del Harris,MIL,2,6,82,49,33,164,91,73,492,232,260,0.47200000000000003,9.0,3.0,6.0,14.0,5.0,9.0,45.0,20.0,25.0,1988
1285,Willis Reed,NJN,2,4,82,26,56,110,33,77,206,82,124,0.39799999999999996,,,,,,,6.0,2.0,4.0,1988
1286,Rick Pitino,NYK,2,2,82,52,30,164,90,74,164,90,74,0.5489999999999999,9.0,5.0,4.0,13.0,6.0,7.0,13.0,6.0,7.0,1988
1287,Jim Lynam,PHI,2,4,82,46,36,121,62,59,264,114,150,0.43200000000000005,3.0,0.0,3.0,3.0,0.0,3.0,3.0,0.0,3.0,1988
1288,Cotton Fitzsimmons,PHO,3,16,82,55,27,246,152,94,1304,643,661,0.493,12.0,7.0,5.0,12.0,7.0,5.0,52.0,20.0,32.0,1988
1289,Mike Schuler,POR,3,3,47,25,22,211,127,84,211,127,84,0.602,,,,8.0,2.0,6.0,8.0,2.0,6.0,1988
1290,Rick Adelman,POR,1,1,35,14,21,35,14,21,35,14,21,0.4,3.0,0.0,3.0,3.0,0.0,3.0,3.0,0.0,3.0,1988
1291,Jerry Reynolds,SAC,3,3,82,27,55,142,49,93,142,49,93,0.345,,,,,,,,,,1988
1292,Larry Brown,SAS,1,10,82,21,61,82,21,61,793,467,326,0.589,,,,,,,63.0,28.0,35.0,1988
1293,Bernie Bickerstaff,SEA,4,4,82,47,35,328,161,167,328,161,167,0.491,8.0,3.0,5.0,27.0,12.0,15.0,27.0,12.0,15.0,1988
1294,Frank Layden,UTA,8,8,17,11,6,571,277,294,571,277,294,0.485,,,,41.0,18.0,23.0,41.0,18.0,23.0,1988
1295,Jerry Sloan,UTA,1,4,65,40,25,65,40,25,280,134,146,0.479,3.0,0.0,3.0,3.0,0.0,3.0,9.0,2.0,7.0,1988
1296,Wes Unseld,WSB,2,2,82,40,42,137,70,67,137,70,67,0.511,,,,5.0,2.0,3.0,5.0,2.0,3.0,1988
1297,Terry Stotts,ATL,2,2,82,28,54,137,52,85,137,52,85,0.38,,,,,,,,,,2003
1298,Jim O'Brien,BOS,4,4,46,22,24,258,139,119,258,139,119,0.539,,,,26.0,13.0,13.0,26.0,13.0,13.0,2003
1299,John Carroll,BOS,1,1,36,14,22,36,14,22,36,14,22,0.389,4.0,0.0,4.0,4.0,0.0,4.0,4.0,0.0,4.0,2003
1300,Bill Cartwright,CHI,3,3,14,4,10,151,51,100,151,51,100,0.33799999999999997,,,,,,,,,,2003
1301,Pete Myers,CHI,1,1,2,0,2,2,0,2,2,0,2,0.0,,,,,,,,,,2003
1302,Scott Skiles,CHI,1,4,66,19,47,66,19,47,261,135,126,0.517,,,,,,,13.0,5.0,8.0,2003
1303,Paul Silas,CLE,1,9,82,35,47,82,35,47,691,321,370,0.465,,,,,,,29.0,13.0,16.0,2003
1304,Don Nelson,DAL,7,26,82,52,30,526,297,229,2006,1148,858,0.5720000000000001,5.0,1.0,4.0,43.0,19.0,24.0,155.0,70.0,85.0,2003
1305,Jeff Bzdelik,DEN,2,2,82,43,39,164,60,104,164,60,104,0.366,5.0,1.0,4.0,5.0,1.0,4.0,5.0,1.0,4.0,2003
1306,Larry Brown,DET,1,25,82,54,28,82,54,28,1982,1162,820,0.586,23.0,16.0,7.0,23.0,16.0,7.0,206.0,105.0,101.0,2003
1307,Eric Musselman,GSW,2,2,82,37,45,164,75,89,164,75,89,0.457,,,,,,,,,,2003
1308,Jeff Van Gundy,HOU,1,8,82,45,37,82,45,37,502,293,209,0.584,5.0,1.0,4.0,5.0,1.0,4.0,74.0,38.0,36.0,2003
1309,Rick Carlisle,IND,1,3,82,61,21,82,61,21,246,161,85,0.654,16.0,10.0,6.0,16.0,10.0,6.0,43.0,22.0,21.0,2003
1310,Mike Dunleavy,LAC,1,11,82,28,54,82,28,54,870,426,444,0.49,,,,,,,59.0,31.0,28.0,2003
1311,Phil Jackson,LAL,5,14,82,56,26,410,287,123,1148,832,316,0.725,22.0,13.0,9.0,92.0,64.0,28.0,244.0,175.0,69.0,2003
1312,Hubie Brown,MEM,2,14,82,50,32,156,78,78,1075,523,552,0.48700000000000004,4.0,0.0,4.0,4.0,0.0,4.0,63.0,31.0,32.0,2003
1313,Stan Van Gundy,MIA,1,1,82,42,40,82,42,40,82,42,40,0.512,13.0,6.0,7.0,13.0,6.0,7.0,13.0,6.0,7.0,2003
1314,Terry Porter,MIL,1,1,82,41,41,82,41,41,82,41,41,0.5,5.0,1.0,4.0,5.0,1.0,4.0,5.0,1.0,4.0,2003
1315,Flip Saunders,MIN,9,9,82,58,24,686,386,300,686,386,300,0.563,18.0,10.0,8.0,47.0,17.0,30.0,47.0,17.0,30.0,2003
1316,Byron Scott,NJN,4,4,42,22,20,288,149,139,288,149,139,0.517,,,,40.0,25.0,15.0,40.0,25.0,15.0,2003
1317,Lawrence Frank,NJN,1,1,40,25,15,40,25,15,40,25,15,0.625,11.0,7.0,4.0,11.0,7.0,4.0,11.0,7.0,4.0,2003
1318,Tim Floyd,NOH,1,5,82,41,41,82,41,41,321,90,231,0.28,7.0,3.0,4.0,7.0,3.0,4.0,7.0,3.0,4.0,2003
1319,Don Chaney,NYK,3,12,39,15,24,184,72,112,831,337,494,0.406,,,,,,,11.0,2.0,9.0,2003
1320,Herb Williams,NYK,1,1,1,1,0,1,1,0,1,1,0,1.0,,,,,,,,,,2003
1321,Lenny Wilkens,NYK,1,31,42,23,19,42,23,19,2448,1315,1133,0.537,4.0,0.0,4.0,4.0,0.0,4.0,178.0,80.0,98.0,2003
1322,Doc Rivers,ORL,5,5,11,1,10,339,171,168,339,171,168,0.504,,,,15.0,5.0,10.0,15.0,5.0,10.0,2003
1323,Johnny Davis,ORL,1,2,71,20,51,71,20,51,153,42,111,0.275,,,,,,,,,,2003
1324,Randy Ayers,PHI,1,1,52,21,31,52,21,31,52,21,31,0.40399999999999997,,,,,,,,,,2003
1325,Chris Ford,PHI,1,10,30,12,18,30,12,18,699,323,376,0.462,,,,,,,29.0,13.0,16.0,2003
1326,Frank Johnson,PHO,3,3,21,8,13,134,63,71,134,63,71,0.47,,,,6.0,2.0,4.0,6.0,2.0,4.0,2003
1327,Mike D'Antoni,PHO,1,2,61,21,40,61,21,40,111,35,76,0.315,,,,,,,,,,2003
1328,Maurice Cheeks,POR,3,3,82,41,41,246,140,106,246,140,106,0.569,,,,10.0,3.0,7.0,10.0,3.0,7.0,2003
1329,Rick Adelman,SAC,6,14,82,55,27,460,301,159,1069,658,411,0.616,12.0,7.0,5.0,58.0,31.0,27.0,127.0,67.0,60.0,2003
1330,Gregg Popovich,SAS,8,8,82,57,25,606,396,210,606,396,210,0.653,10.0,6.0,4.0,87.0,53.0,34.0,87.0,53.0,34.0,2003
1331,Nate McMillan,SEA,4,4,82,37,45,313,160,153,313,160,153,0.511,,,,5.0,2.0,3.0,5.0,2.0,3.0,2003
1332,Kevin O'Neill,TOR,1,1,82,33,49,82,33,49,82,33,49,0.402,,,,,,,,,,2003
1333,Jerry Sloan,UTA,16,19,82,42,40,1263,823,440,1478,917,561,0.62,,,,152.0,76.0,76.0,158.0,78.0,80.0,2003
1334,Eddie Jordan,WAS,1,3,82,25,57,82,25,57,179,58,121,0.324,,,,,,,,,,2003
1335,Mike Fratello,ATL,2,2,82,40,42,85,40,45,85,40,45,0.47100000000000003,5.0,2.0,3.0,5.0,2.0,3.0,5.0,2.0,3.0,1983
1336,K.C. Jones,BOS,1,5,82,62,20,82,62,20,412,247,165,0.6,23.0,15.0,8.0,23.0,15.0,8.0,58.0,29.0,29.0,1983
1337,Kevin Loughery,CHI,1,12,82,27,55,82,27,55,892,414,478,0.46399999999999997,,,,,,,39.0,22.0,17.0,1983
1338,Tom Nissalke,CLE,2,13,82,28,54,164,51,113,879,371,508,0.42200000000000004,,,,,,,31.0,11.0,20.0,1983
1339,Dick Motta,DAL,4,16,82,43,39,328,124,204,1312,665,647,0.507,10.0,4.0,6.0,10.0,4.0,6.0,108.0,49.0,59.0,1983
1340,Doug Moe,DEN,4,8,82,38,44,297,155,142,609,332,277,0.545,5.0,2.0,3.0,16.0,6.0,10.0,38.0,15.0,23.0,1983
1341,Chuck Daly,DET,1,2,82,49,33,82,49,33,123,58,65,0.47200000000000003,5.0,2.0,3.0,5.0,2.0,3.0,5.0,2.0,3.0,1983
1342,Johnny Bach,GSW,2,2,82,37,45,103,43,60,103,43,60,0.41700000000000004,,,,,,,,,,1983
1343,Bill Fitch,HOU,1,14,82,29,53,82,29,53,1148,575,573,0.501,,,,,,,63.0,33.0,30.0,1983
1344,Jack McKinney,IND,4,5,82,26,56,328,125,203,342,135,207,0.395,,,,2.0,0.0,2.0,2.0,0.0,2.0,1983
1345,Cotton Fitzsimmons,KCK,6,13,82,38,44,492,248,244,1058,512,546,0.484,3.0,0.0,3.0,26.0,9.0,17.0,32.0,11.0,21.0,1983
1346,Pat Riley,LAL,3,3,82,54,28,235,162,73,235,162,73,0.6890000000000001,21.0,14.0,7.0,50.0,34.0,16.0,50.0,34.0,16.0,1983
1347,Don Nelson,MIL,8,8,82,50,32,638,374,264,638,374,264,0.586,16.0,8.0,8.0,54.0,26.0,28.0,54.0,26.0,28.0,1983
1348,Stan Albeck,NJN,1,6,82,45,37,82,45,37,481,262,219,0.545,11.0,5.0,6.0,11.0,5.0,6.0,38.0,18.0,20.0,1983
1349,Hubie Brown,NYK,2,9,82,47,35,164,91,73,739,394,345,0.5329999999999999,12.0,6.0,6.0,18.0,8.0,10.0,59.0,31.0,28.0,1983
1350,Billy Cunningham,PHI,7,7,82,52,30,568,396,172,568,396,172,0.6970000000000001,5.0,2.0,3.0,92.0,58.0,34.0,92.0,58.0,34.0,1983
1351,John MacLeod,PHO,11,11,82,41,41,902,489,413,902,489,413,0.542,17.0,9.0,8.0,78.0,37.0,41.0,78.0,37.0,41.0,1983
1352,Jack Ramsay,POR,8,16,82,48,34,656,371,285,1312,703,609,0.536,5.0,2.0,3.0,46.0,24.0,22.0,85.0,38.0,47.0,1983
1353,Morris McHone,SAS,1,1,31,11,20,31,11,20,31,11,20,0.355,,,,,,,,,,1983
1354,Bob Bass,SAS,4,9,51,26,25,207,117,90,567,285,282,0.503,,,,16.0,6.0,10.0,38.0,13.0,25.0,1983
1355,Jim Lynam,SDC,1,1,82,30,52,82,30,52,82,30,52,0.366,,,,,,,,,,1983
1356,Lenny Wilkens,SEA,10,12,82,42,40,798,447,351,962,522,440,0.5429999999999999,5.0,2.0,3.0,69.0,37.0,32.0,69.0,37.0,32.0,1983
1357,Frank Layden,UTA,3,3,82,45,37,226,92,134,226,92,134,0.40700000000000003,11.0,5.0,6.0,11.0,5.0,6.0,11.0,5.0,6.0,1983
1358,Gene Shue,WSB,11,18,82,35,47,876,450,426,1374,685,689,0.499,4.0,1.0,3.0,51.0,18.0,33.0,73.0,29.0,44.0,1983
1359,Bob Weiss,ATL,2,4,82,38,44,164,81,83,328,140,188,0.42700000000000005,,,,5.0,2.0,3.0,8.0,2.0,6.0,1991
1360,Chris Ford,BOS,2,2,82,51,31,164,107,57,164,107,57,0.652,10.0,6.0,4.0,21.0,11.0,10.0,21.0,11.0,10.0,1991
1361,Allan Bristow,CHH,1,1,82,31,51,82,31,51,82,31,51,0.37799999999999995,,,,,,,,,,1991
1362,Phil Jackson,CHI,3,3,82,67,15,246,183,63,246,183,63,0.7440000000000001,22.0,15.0,7.0,55.0,40.0,15.0,55.0,40.0,15.0,1991
1363,Lenny Wilkens,CLE,6,19,82,57,25,492,262,230,1536,815,721,0.531,17.0,9.0,8.0,32.0,15.0,17.0,101.0,52.0,49.0,1991
1364,Richie Adubato,DAL,3,4,82,22,60,235,92,143,305,104,201,0.341,,,,3.0,0.0,3.0,3.0,0.0,3.0,1991
1365,Paul Westhead,DEN,2,6,82,24,58,164,44,120,407,183,224,0.45,,,,,,,19.0,13.0,6.0,1991
1366,Chuck Daly,DET,9,10,82,48,34,738,467,271,779,476,303,0.611,5.0,2.0,3.0,113.0,71.0,42.0,113.0,71.0,42.0,1991
1367,Don Nelson,GSW,4,15,82,55,27,328,179,149,1212,719,493,0.593,4.0,1.0,3.0,21.0,9.0,12.0,109.0,51.0,58.0,1991
1368,Don Chaney,HOU,4,7,52,26,26,298,164,134,483,217,266,0.449,,,,11.0,2.0,9.0,11.0,2.0,9.0,1991
1369,Rudy Tomjanovich,HOU,1,1,30,16,14,30,16,14,30,16,14,0.5329999999999999,,,,,,,,,,1991
1370,Bob Hill,IND,2,3,82,40,42,139,72,67,205,92,113,0.449,3.0,0.0,3.0,8.0,2.0,6.0,8.0,2.0,6.0,1991
1371,Mike Schuler,LAC,2,5,45,21,24,127,52,75,338,179,159,0.53,,,,,,,8.0,2.0,6.0,1991
1372,Mack Calvin,LAC,1,2,2,1,1,2,1,1,8,1,7,0.125,,,,,,,,,,1991
1373,Larry Brown,LAC,1,13,35,23,12,35,23,12,1030,622,408,0.604,5.0,2.0,3.0,5.0,2.0,3.0,82.0,37.0,45.0,1991
1374,Mike Dunleavy,LAL,2,2,82,43,39,164,101,63,164,101,63,0.616,4.0,1.0,3.0,23.0,13.0,10.0,23.0,13.0,10.0,1991
1375,Kevin Loughery,MIA,1,17,82,38,44,82,38,44,1178,547,631,0.46399999999999997,3.0,0.0,3.0,3.0,0.0,3.0,54.0,25.0,29.0,1991
1376,Del Harris,MIL,5,9,17,8,9,345,191,154,673,332,341,0.493,,,,21.0,6.0,15.0,52.0,21.0,31.0,1991
1377,Frank Hamblen,MIL,1,1,65,23,42,65,23,42,65,23,42,0.354,,,,,,,,,,1991
1378,Jimmy Rodgers,MIN,1,3,82,15,67,82,15,67,246,109,137,0.44299999999999995,,,,,,,8.0,2.0,6.0,1991
1379,Bill Fitch,NJN,3,21,82,40,42,246,83,163,1722,845,877,0.491,4.0,1.0,3.0,4.0,1.0,3.0,106.0,55.0,51.0,1991
1380,Pat Riley,NYK,1,10,82,51,31,82,51,31,809,584,225,0.722,12.0,6.0,6.0,12.0,6.0,6.0,161.0,108.0,53.0,1991
1381,Matt Guokas,ORL,3,6,82,21,61,246,70,176,453,189,264,0.41700000000000004,,,,,,,17.0,8.0,9.0,1991
1382,Jim Lynam,PHI,5,7,82,35,47,367,194,173,510,246,264,0.48200000000000004,,,,21.0,8.0,13.0,21.0,8.0,13.0,1991
1383,Cotton Fitzsimmons,PHO,6,19,82,53,29,492,314,178,1550,805,745,0.519,8.0,4.0,4.0,40.0,21.0,19.0,80.0,34.0,46.0,1991
1384,Rick Adelman,POR,4,4,82,57,25,281,193,88,281,193,88,0.687,21.0,13.0,8.0,61.0,34.0,27.0,61.0,34.0,27.0,1991
1385,Dick Motta,SAC,3,22,25,7,18,161,48,113,1719,856,863,0.498,,,,,,,126.0,56.0,70.0,1991
1386,Rex Hughes,SAC,1,1,57,22,35,57,22,35,57,22,35,0.386,,,,,,,,,,1991
1387,Larry Brown,SAS,4,13,38,21,17,284,153,131,1030,622,408,0.604,,,,14.0,7.0,7.0,82.0,37.0,45.0,1991
1388,Bob Bass,SAS,5,10,44,26,18,251,143,108,611,311,300,0.509,3.0,0.0,3.0,19.0,6.0,13.0,41.0,13.0,28.0,1991
1389,K.C. Jones,SEA,2,11,36,18,18,118,59,59,858,552,306,0.643,,,,5.0,2.0,3.0,142.0,81.0,61.0,1991
1390,Bob Kloppenburg,SEA,1,2,4,2,2,4,2,2,7,2,5,0.28600000000000003,,,,,,,,,,1991
1391,George Karl,SEA,1,5,42,27,15,42,27,15,337,146,191,0.433,9.0,4.0,5.0,9.0,4.0,5.0,23.0,9.0,14.0,1991
1392,Jerry Sloan,UTA,4,7,82,55,27,311,204,107,526,298,228,0.5670000000000001,16.0,9.0,7.0,33.0,15.0,18.0,39.0,17.0,22.0,1991
1393,Wes Unseld,WSB,5,5,82,25,57,383,156,227,383,156,227,0.40700000000000003,,,,5.0,2.0,3.0,5.0,2.0,3.0,1991
1394,Hubie Brown,ATL,5,7,79,31,48,407,199,208,575,303,272,0.527,,,,16.0,6.0,10.0,41.0,23.0,18.0,1980
1395,Mike Fratello,ATL,1,1,3,0,3,3,0,3,3,0,3,0.0,,,,,,,,,,1980
1396,Bill Fitch,BOS,2,11,82,62,20,164,123,41,902,427,475,0.473,17.0,12.0,5.0,26.0,17.0,9.0,44.0,24.0,20.0,1980
1397,Jerry Sloan,CHI,2,2,82,45,37,164,75,89,164,75,89,0.457,6.0,2.0,4.0,6.0,2.0,4.0,6.0,2.0,4.0,1980
1398,Bill Musselman,CLE,1,2,71,25,46,71,25,46,108,32,76,0.29600000000000004,,,,,,,,,,1980
1399,Don Delaney,CLE,1,1,11,3,8,11,3,8,11,3,8,0.273,,,,,,,,,,1980
1400,Dick Motta,DAL,1,13,82,15,67,82,15,67,1066,556,510,0.522,,,,,,,98.0,45.0,53.0,1980
1401,Donnie Walsh,DEN,3,3,31,11,20,142,60,82,142,60,82,0.423,,,,3.0,1.0,2.0,3.0,1.0,2.0,1980
1402,Doug Moe,DEN,1,5,51,26,25,51,26,25,363,203,160,0.5589999999999999,,,,,,,22.0,9.0,13.0,1980
1403,Scotty Robertson,DET,1,3,82,21,61,82,21,61,123,33,90,0.268,,,,,,,,,,1980
1404,Al Attles,GSW,12,12,82,39,43,911,482,429,911,482,429,0.529,,,,61.0,31.0,30.0,61.0,31.0,30.0,1980
1405,Del Harris,HOU,2,2,82,40,42,164,81,83,164,81,83,0.494,21.0,12.0,9.0,28.0,14.0,14.0,28.0,14.0,14.0,1980
1406,Jack McKinney,IND,1,2,82,44,38,82,44,38,96,54,42,0.563,2.0,0.0,2.0,2.0,0.0,2.0,2.0,0.0,2.0,1980
1407,Cotton Fitzsimmons,KCK,3,10,82,40,42,246,135,111,812,399,413,0.491,15.0,7.0,8.0,23.0,9.0,14.0,29.0,11.0,18.0,1980
1408,Paul Westhead,LAL,2,2,82,54,28,150,104,46,150,104,46,0.693,3.0,1.0,2.0,19.0,13.0,6.0,19.0,13.0,6.0,1980
1409,Don Nelson,MIL,5,5,82,60,22,392,218,174,392,218,174,0.556,7.0,3.0,4.0,23.0,11.0,12.0,23.0,11.0,12.0,1980
1410,Kevin Loughery,NJN,8,9,35,12,23,615,297,318,646,302,344,0.467,,,,34.0,21.0,13.0,34.0,21.0,13.0,1980
1411,Bob MacKinnon,NJN,1,3,47,12,35,47,12,35,138,47,91,0.341,,,,,,,10.0,5.0,5.0,1980
1412,Red Holzman,NYK,13,17,82,50,32,1014,580,434,1217,663,554,0.545,2.0,0.0,2.0,97.0,54.0,43.0,105.0,58.0,47.0,1980
1413,Billy Cunningham,PHI,4,4,82,62,20,322,221,101,322,221,101,0.6859999999999999,16.0,9.0,7.0,53.0,32.0,21.0,53.0,32.0,21.0,1980
1414,John MacLeod,PHO,8,8,82,57,25,656,349,307,656,349,307,0.532,7.0,3.0,4.0,51.0,25.0,26.0,51.0,25.0,26.0,1980
1415,Jack Ramsay,POR,5,13,82,45,37,410,235,175,1066,567,499,0.532,3.0,1.0,2.0,34.0,19.0,15.0,73.0,33.0,40.0,1980
1416,Stan Albeck,SAS,1,3,82,52,30,82,52,30,235,116,119,0.494,7.0,3.0,4.0,7.0,3.0,4.0,7.0,3.0,4.0,1980
1417,Paul Silas,SDC,1,1,82,36,46,82,36,46,82,36,46,0.439,,,,,,,,,,1980
1418,Lenny Wilkens,SEA,7,9,82,34,48,552,305,247,716,380,336,0.531,,,,54.0,32.0,22.0,54.0,32.0,22.0,1980
1419,Tom Nissalke,UTA,2,10,82,28,54,164,52,112,695,312,383,0.449,,,,,,,31.0,11.0,20.0,1980
1420,Gene Shue,WSB,8,15,82,39,43,630,330,300,1128,565,563,0.501,,,,40.0,14.0,26.0,62.0,25.0,37.0,1980
1421,Red Auerbach,BOS,6,10,72,39,33,422,241,181,647,384,263,0.594,3.0,1.0,2.0,27.0,10.0,17.0,47.0,19.0,28.0,1955
1422,Charles Eckman,FTW,2,2,72,37,35,144,80,64,144,80,64,0.556,10.0,4.0,6.0,21.0,10.0,11.0,21.0,10.0,11.0,1955
1423,John Kundla,MNL,8,8,72,33,39,548,346,202,548,346,202,0.631,3.0,1.0,2.0,77.0,52.0,25.0,77.0,52.0,25.0,1955
1424,Joe Lapchick,NYK,9,9,51,26,25,573,326,247,573,326,247,0.569,,,,60.0,30.0,30.0,60.0,30.0,30.0,1955
1425,Vince Boryla,NYK,1,1,21,9,12,21,9,12,21,9,12,0.429,,,,,,,,,,1955
1426,George Senesky,PHW,1,1,72,45,27,72,45,27,72,45,27,0.625,10.0,7.0,3.0,10.0,7.0,3.0,10.0,7.0,3.0,1955
1427,Bobby Wanzer,ROC,1,1,72,31,41,72,31,41,72,31,41,0.431,,,,,,,,,,1955
1428,Red Holzman,STL,3,3,72,33,39,170,69,101,170,69,101,0.406,8.0,4.0,4.0,8.0,4.0,4.0,8.0,4.0,4.0,1955
1429,Al Cervi,SYR,7,7,72,35,37,483,290,193,483,290,193,0.6,8.0,4.0,4.0,59.0,33.0,26.0,59.0,33.0,26.0,1955
1430,Red Auerbach,BOS,10,14,75,59,16,713,445,268,938,588,350,0.627,13.0,8.0,5.0,72.0,39.0,33.0,92.0,48.0,44.0,1959
1431,Tom Marshall,CIN,2,2,75,19,56,129,35,94,129,35,94,0.271,,,,,,,,,,1959
1432,Red Rocha,DET,3,3,34,13,21,153,65,88,153,65,88,0.425,,,,10.0,4.0,6.0,10.0,4.0,6.0,1959
1433,Dick McGuire,DET,1,1,41,17,24,41,17,24,41,17,24,0.415,2.0,0.0,2.0,2.0,0.0,2.0,2.0,0.0,2.0,1959
1434,John Castellani,MNL,1,1,36,11,25,36,11,25,36,11,25,0.306,,,,,,,,,,1959
1435,Jim Pollard,MNL,1,1,39,14,25,39,14,25,39,14,25,0.359,9.0,5.0,4.0,9.0,5.0,4.0,9.0,5.0,4.0,1959
1436,Andrew Levane,NYK,2,4,27,8,19,99,48,51,216,86,130,0.39799999999999996,,,,2.0,0.0,2.0,2.0,0.0,2.0,1959
1437,Carl Braun,NYK,1,1,48,19,29,48,19,29,48,19,29,0.396,,,,,,,,,,1959
1438,Neil Johnston,PHW,1,1,75,49,26,75,49,26,75,49,26,0.653,9.0,4.0,5.0,9.0,4.0,5.0,9.0,4.0,5.0,1959
1439,Ed Macauley,STL,2,2,75,46,29,137,89,48,137,89,48,0.65,14.0,7.0,7.0,20.0,9.0,11.0,20.0,9.0,11.0,1959
1440,Paul Seymour,SYR,4,4,75,45,30,279,155,124,279,155,124,0.556,3.0,1.0,2.0,20.0,9.0,11.0,20.0,9.0,11.0,1959
1441,Mike Fratello,ATL,6,6,82,50,32,413,231,182,413,231,182,0.5589999999999999,12.0,6.0,6.0,35.0,16.0,19.0,35.0,16.0,19.0,1987
1442,K.C. Jones,BOS,5,9,82,57,25,410,308,102,740,493,247,0.6659999999999999,17.0,9.0,8.0,102.0,65.0,37.0,137.0,79.0,58.0,1987
1443,Doug Collins,CHI,2,2,82,50,32,164,90,74,164,90,74,0.5489999999999999,10.0,4.0,6.0,13.0,4.0,9.0,13.0,4.0,9.0,1987
1444,Lenny Wilkens,CLE,2,15,82,42,40,164,73,91,1208,626,582,0.518,5.0,2.0,3.0,5.0,2.0,3.0,74.0,39.0,35.0,1987
1445,John MacLeod,DAL,1,15,82,53,29,82,53,29,1204,632,572,0.525,17.0,10.0,7.0,17.0,10.0,7.0,98.0,47.0,51.0,1987
1446,Doug Moe,DEN,8,12,82,54,28,625,345,280,937,522,415,0.557,11.0,5.0,6.0,55.0,24.0,31.0,77.0,33.0,44.0,1987
1447,Chuck Daly,DET,5,6,82,54,28,410,247,163,451,256,195,0.568,23.0,14.0,9.0,56.0,32.0,24.0,56.0,32.0,24.0,1987
1448,George Karl,GSW,2,4,64,16,48,146,58,88,295,119,176,0.40299999999999997,,,,10.0,4.0,6.0,14.0,5.0,9.0,1987
1449,Ed Gregory,GSW,1,1,18,4,14,18,4,14,18,4,14,0.222,,,,,,,,,,1987
1450,Bill Fitch,HOU,5,18,82,46,36,410,216,194,1476,762,714,0.516,4.0,1.0,3.0,39.0,21.0,18.0,102.0,54.0,48.0,1987
1451,Jack Ramsay,IND,2,20,82,38,44,164,79,85,1640,864,776,0.527,,,,4.0,1.0,3.0,102.0,44.0,58.0,1987
1452,Gene Shue,LAC,3,21,82,17,65,246,95,151,1607,774,833,0.48200000000000004,,,,,,,77.0,30.0,47.0,1987
1453,Pat Riley,LAL,7,7,82,62,20,563,413,150,563,413,150,0.7340000000000001,24.0,15.0,9.0,125.0,87.0,38.0,125.0,87.0,38.0,1987
1454,Del Harris,MIL,1,5,82,42,40,82,42,40,410,183,227,0.446,5.0,2.0,3.0,5.0,2.0,3.0,36.0,17.0,19.0,1987
1455,Dave Wohl,NJN,3,3,15,2,13,179,65,114,179,65,114,0.363,,,,3.0,0.0,3.0,3.0,0.0,3.0,1987
1456,Bob MacKinnon,NJN,2,4,39,10,29,86,22,64,177,57,120,0.322,,,,,,,10.0,5.0,5.0,1987
1457,Willis Reed,NJN,1,3,28,7,21,28,7,21,124,56,68,0.452,,,,,,,6.0,2.0,4.0,1987
1458,Rick Pitino,NYK,1,1,82,38,44,82,38,44,82,38,44,0.46299999999999997,4.0,1.0,3.0,4.0,1.0,3.0,4.0,1.0,3.0,1987
1459,Matt Guokas,PHI,3,3,43,20,23,207,119,88,207,119,88,0.575,,,,17.0,8.0,9.0,17.0,8.0,9.0,1987
1460,Jim Lynam,PHI,1,3,39,16,23,39,16,23,182,68,114,0.374,,,,,,,,,,1987
1461,John Wetzel,PHO,1,1,82,28,54,82,28,54,82,28,54,0.341,,,,,,,,,,1987
1462,Mike Schuler,POR,2,2,82,53,29,164,102,62,164,102,62,0.622,4.0,1.0,3.0,8.0,2.0,6.0,8.0,2.0,6.0,1987
1463,Bill Russell,SAC,1,8,58,17,41,58,17,41,631,341,290,0.54,,,,,,,61.0,34.0,27.0,1987
1464,Jerry Reynolds,SAC,2,2,24,7,17,60,22,38,60,22,38,0.36700000000000005,,,,,,,,,,1987
1465,Bob Weiss,SAS,2,2,82,31,51,164,59,105,164,59,105,0.36,3.0,0.0,3.0,3.0,0.0,3.0,3.0,0.0,3.0,1987
1466,Bernie Bickerstaff,SEA,3,3,82,44,38,246,114,132,246,114,132,0.46299999999999997,5.0,2.0,3.0,19.0,9.0,10.0,19.0,9.0,10.0,1987
1467,Frank Layden,UTA,7,7,82,47,35,554,266,288,554,266,288,0.48,11.0,6.0,5.0,41.0,18.0,23.0,41.0,18.0,23.0,1987
1468,Kevin Loughery,WSB,3,16,27,8,19,122,57,65,1096,509,587,0.46399999999999997,,,,8.0,2.0,6.0,51.0,25.0,26.0,1987
1469,Wes Unseld,WSB,1,1,55,30,25,55,30,25,55,30,25,0.545,5.0,2.0,3.0,5.0,2.0,3.0,5.0,2.0,3.0,1987
1470,Buddy Jeannette,BLB,4,4,37,14,23,213,96,117,213,96,117,0.451,,,,14.0,9.0,5.0,14.0,9.0,5.0,1950
1471,Walt Budko,BLB,1,1,29,10,19,29,10,19,29,10,19,0.345,,,,,,,,,,1950
1472,Red Auerbach,BOS,1,5,69,39,30,69,39,30,294,182,112,0.619,2.0,0.0,2.0,2.0,0.0,2.0,22.0,9.0,13.0,1950
1473,Murray Mendenhall,FTW,2,2,68,32,36,136,72,64,136,72,64,0.529,3.0,1.0,2.0,7.0,3.0,4.0,7.0,3.0,4.0,1950
1474,Wally Jones,INO,1,1,12,7,5,12,7,5,12,7,5,0.583,3.0,1.0,2.0,3.0,1.0,2.0,3.0,1.0,2.0,1950
1475,John Kundla,MNL,3,3,68,44,24,196,139,57,196,139,57,0.7090000000000001,7.0,3.0,4.0,29.0,21.0,8.0,29.0,21.0,8.0,1950
1476,Joe Lapchick,NYK,4,4,66,36,30,242,134,108,242,134,108,0.5539999999999999,14.0,8.0,6.0,28.0,15.0,13.0,28.0,15.0,13.0,1950
1477,Edward Gottlieb,PHW,5,5,66,40,26,302,156,146,302,156,146,0.517,2.0,0.0,2.0,29.0,14.0,15.0,29.0,14.0,15.0,1950
1478,Les Harrison,ROC,3,3,68,41,27,196,137,59,196,137,59,0.6990000000000001,14.0,9.0,5.0,20.0,11.0,9.0,20.0,11.0,9.0,1950
1479,Al Cervi,SYR,2,2,66,32,34,130,83,47,130,83,47,0.638,7.0,4.0,3.0,18.0,10.0,8.0,18.0,10.0,8.0,1950
1480,Dave McMillan,TRI,1,1,23,9,14,23,9,14,23,9,14,0.391,,,,,,,,,,1950
1481,John Logan,TRI,1,1,3,2,1,3,2,1,3,2,1,0.667,,,,,,,,,,1950
1482,Mike Todorovich,TRI,1,1,42,14,28,42,14,28,42,14,28,0.33299999999999996,,,,,,,,,,1950
1483,Bones McKinney,WSC,1,1,35,10,25,35,10,25,35,10,25,0.28600000000000003,,,,,,,,,,1950
1484,Red Auerbach,BOS,9,13,72,52,20,638,386,252,863,529,334,0.613,11.0,8.0,3.0,59.0,31.0,28.0,79.0,40.0,39.0,1958
1485,Bobby Wanzer,CIN,4,4,18,3,15,234,98,136,234,98,136,0.419,,,,2.0,0.0,2.0,2.0,0.0,2.0,1958
1486,Tom Marshall,CIN,1,1,54,16,38,54,16,38,54,16,38,0.29600000000000004,,,,,,,,,,1958
1487,Red Rocha,DET,2,2,72,28,44,119,52,67,119,52,67,0.43700000000000006,3.0,1.0,2.0,10.0,4.0,6.0,10.0,4.0,6.0,1958
1488,John Kundla,MNL,11,11,72,33,39,725,423,302,725,423,302,0.583,13.0,6.0,7.0,95.0,60.0,35.0,95.0,60.0,35.0,1958
1489,Andrew Levane,NYK,1,3,72,40,32,72,40,32,189,78,111,0.413,2.0,0.0,2.0,2.0,0.0,2.0,2.0,0.0,2.0,1958
1490,Al Cervi,PHW,1,9,72,32,40,72,32,40,567,326,241,0.575,,,,,,,59.0,33.0,26.0,1958
1491,Andy Phillip,STL,1,1,10,6,4,10,6,4,10,6,4,0.6,,,,,,,,,,1958
1492,Ed Macauley,STL,1,1,62,43,19,62,43,19,62,43,19,0.6940000000000001,6.0,2.0,4.0,6.0,2.0,4.0,6.0,2.0,4.0,1958
1493,Paul Seymour,SYR,3,3,72,35,37,204,110,94,204,110,94,0.539,9.0,5.0,4.0,17.0,8.0,9.0,17.0,8.0,9.0,1958
1494,Chick Reiser,BLB,2,2,3,0,3,30,8,22,30,8,22,0.267,,,,,,,,,,1952
1495,Clair Bee,BLB,1,1,67,16,51,67,16,51,67,16,51,0.239,2.0,0.0,2.0,2.0,0.0,2.0,2.0,0.0,2.0,1952
1496,Red Auerbach,BOS,3,7,71,46,25,206,124,82,431,267,164,0.619,6.0,3.0,3.0,11.0,4.0,7.0,31.0,13.0,18.0,1952
1497,Paul Birch,FTW,2,3,69,36,33,135,65,70,195,80,115,0.41,8.0,4.0,4.0,10.0,4.0,6.0,10.0,4.0,6.0,1952
1498,Herm Schaefer,INO,2,2,71,28,43,137,62,75,137,62,75,0.45299999999999996,2.0,0.0,2.0,4.0,0.0,4.0,4.0,0.0,4.0,1952
1499,Andrew Levane,MLH,1,1,71,27,44,71,27,44,71,27,44,0.38,,,,,,,,,,1952
1500,John Kundla,MNL,5,5,70,48,22,332,227,105,332,227,105,0.684,12.0,9.0,3.0,54.0,39.0,15.0,54.0,39.0,15.0,1952
1501,Joe Lapchick,NYK,6,6,70,47,23,378,218,160,378,218,160,0.5770000000000001,11.0,6.0,5.0,53.0,29.0,24.0,53.0,29.0,24.0,1952
1502,Edward Gottlieb,PHW,7,7,69,12,57,437,201,236,437,201,236,0.46,,,,32.0,15.0,17.0,32.0,15.0,17.0,1952
1503,Les Harrison,ROC,5,5,70,44,26,332,222,110,332,222,110,0.669,3.0,1.0,2.0,29.0,15.0,14.0,29.0,15.0,14.0,1952
1504,Al Cervi,SYR,4,4,71,47,24,267,170,97,267,170,97,0.637,2.0,0.0,2.0,27.0,13.0,14.0,27.0,13.0,14.0,1952
1505,Cotton Fitzsimmons,ATL,2,4,82,35,47,164,81,83,328,178,150,0.5429999999999999,,,,6.0,2.0,4.0,6.0,2.0,4.0,1973
1506,Tom Heinsohn,BOS,5,5,82,56,26,410,258,152,410,258,152,0.629,18.0,12.0,6.0,42.0,24.0,18.0,42.0,24.0,18.0,1973
1507,Jack Ramsay,BUF,2,6,82,42,40,164,63,101,492,237,255,0.48200000000000004,6.0,2.0,4.0,6.0,2.0,4.0,23.0,7.0,16.0,1973
1508,K.C. Jones,CAP,1,2,82,47,35,82,47,35,166,77,89,0.46399999999999997,7.0,3.0,4.0,7.0,3.0,4.0,11.0,3.0,8.0,1973
1509,Dick Motta,CHI,6,6,82,54,28,492,285,207,492,285,207,0.579,11.0,4.0,7.0,34.0,11.0,23.0,34.0,11.0,23.0,1973
1510,Bill Fitch,CLE,4,4,82,29,53,328,99,229,328,99,229,0.302,,,,,,,,,,1973
1511,Ray Scott,DET,2,2,82,52,30,157,90,67,157,90,67,0.573,7.0,3.0,4.0,7.0,3.0,4.0,7.0,3.0,4.0,1973
1512,Al Attles,GSW,5,5,82,44,38,358,191,167,358,191,167,0.534,,,,21.0,7.0,14.0,21.0,7.0,14.0,1973
1513,Johnny Egan,HOU,2,2,82,32,50,117,48,69,117,48,69,0.41,,,,,,,,,,1973
1514,Bob Cousy,KCO,5,5,20,6,14,348,141,207,348,141,207,0.405,,,,,,,,,,1973
1515,Draff Young,KCO,1,1,4,0,4,4,0,4,4,0,4,0.0,,,,,,,,,,1973
1516,Phil Johnson,KCO,1,1,58,27,31,58,27,31,58,27,31,0.466,,,,,,,,,,1973
1517,Bill Sharman,LAL,3,8,82,47,35,246,176,70,655,396,259,0.605,5.0,1.0,4.0,37.0,22.0,15.0,97.0,57.0,40.0,1973
1518,Larry Costello,MIL,6,6,82,59,23,492,331,161,492,331,161,0.6729999999999999,16.0,11.0,5.0,57.0,36.0,21.0,57.0,36.0,21.0,1973
1519,Red Holzman,NYK,7,11,82,49,33,536,348,188,739,431,308,0.583,12.0,5.0,7.0,92.0,53.0,39.0,100.0,57.0,43.0,1973
1520,Gene Shue,PHI,1,8,82,25,57,82,25,57,630,316,314,0.502,,,,,,,40.0,14.0,26.0,1973
1521,John MacLeod,PHO,1,1,82,30,52,82,30,52,82,30,52,0.366,,,,,,,,,,1973
1522,Jack McCloskey,POR,2,2,82,27,55,164,48,116,164,48,116,0.293,,,,,,,,,,1973
1523,Bill Russell,SEA,1,4,82,36,46,82,36,46,327,198,129,0.606,,,,,,,46.0,28.0,18.0,1973
1524,Hubie Brown,ATL,4,6,82,50,32,328,168,160,496,272,224,0.5479999999999999,5.0,1.0,4.0,16.0,6.0,10.0,41.0,23.0,18.0,1979
1525,Bill Fitch,BOS,1,10,82,61,21,82,61,21,820,365,455,0.445,9.0,5.0,4.0,9.0,5.0,4.0,27.0,12.0,15.0,1979
1526,Jerry Sloan,CHI,1,1,82,30,52,82,30,52,82,30,52,0.366,,,,,,,,,,1979
1527,Stan Albeck,CLE,1,2,82,37,45,82,37,45,153,64,89,0.418,,,,,,,,,,1979
1528,Donnie Walsh,DEN,2,2,82,30,52,111,49,62,111,49,62,0.441,,,,3.0,1.0,2.0,3.0,1.0,2.0,1979
1529,Dick Vitale,DET,2,2,12,4,8,94,34,60,94,34,60,0.36200000000000004,,,,,,,,,,1979
1530,Richie Adubato,DET,1,1,70,12,58,70,12,58,70,12,58,0.171,,,,,,,,,,1979
1531,Al Attles,GSW,11,11,61,18,43,829,443,386,829,443,386,0.534,,,,61.0,31.0,30.0,61.0,31.0,30.0,1979
1532,Johnny Bach,GSW,1,1,21,6,15,21,6,15,21,6,15,0.28600000000000003,,,,,,,,,,1979
1533,Del Harris,HOU,1,1,82,41,41,82,41,41,82,41,41,0.5,7.0,2.0,5.0,7.0,2.0,5.0,7.0,2.0,5.0,1979
1534,Slick Leonard,IND,12,14,82,37,45,985,529,456,1107,573,534,0.518,,,,116.0,69.0,47.0,116.0,69.0,47.0,1979
1535,Cotton Fitzsimmons,KCK,2,9,82,47,35,164,95,69,730,359,371,0.49200000000000005,3.0,1.0,2.0,8.0,2.0,6.0,14.0,4.0,10.0,1979
1536,Jack McKinney,LAL,1,1,14,10,4,14,10,4,14,10,4,0.7140000000000001,,,,,,,,,,1979
1537,Paul Westhead,LAL,1,1,68,50,18,68,50,18,68,50,18,0.735,16.0,12.0,4.0,16.0,12.0,4.0,16.0,12.0,4.0,1979
1538,Don Nelson,MIL,4,4,82,49,33,310,158,152,310,158,152,0.51,7.0,3.0,4.0,16.0,8.0,8.0,16.0,8.0,8.0,1979
1539,Kevin Loughery,NJN,7,8,82,34,48,580,285,295,611,290,321,0.475,,,,34.0,21.0,13.0,34.0,21.0,13.0,1979
1540,Red Holzman,NYK,12,16,82,39,43,932,530,402,1135,613,522,0.54,,,,95.0,54.0,41.0,103.0,58.0,45.0,1979
1541,Billy Cunningham,PHI,3,3,82,59,23,240,159,81,240,159,81,0.6629999999999999,18.0,12.0,6.0,37.0,23.0,14.0,37.0,23.0,14.0,1979
1542,John MacLeod,PHO,7,7,82,55,27,574,292,282,574,292,282,0.509,8.0,3.0,5.0,44.0,22.0,22.0,44.0,22.0,22.0,1979
1543,Jack Ramsay,POR,4,12,82,38,44,328,190,138,984,522,462,0.53,3.0,1.0,2.0,31.0,18.0,13.0,70.0,32.0,38.0,1979
1544,Doug Moe,SAS,4,4,66,33,33,312,177,135,312,177,135,0.5670000000000001,,,,22.0,9.0,13.0,22.0,9.0,13.0,1979
1545,Bob Bass,SAS,3,8,16,8,8,156,91,65,516,259,257,0.502,3.0,1.0,2.0,16.0,6.0,10.0,38.0,13.0,25.0,1979
1546,Gene Shue,SDC,2,14,82,35,47,164,78,86,1046,526,520,0.503,,,,,,,62.0,25.0,37.0,1979
1547,Lenny Wilkens,SEA,6,8,82,56,26,470,271,199,634,346,288,0.546,15.0,7.0,8.0,54.0,32.0,22.0,54.0,32.0,22.0,1979
1548,Tom Nissalke,UTA,1,9,82,24,58,82,24,58,613,284,329,0.46299999999999997,,,,,,,31.0,11.0,20.0,1979
1549,Dick Motta,WSB,4,12,82,39,43,328,185,143,984,541,443,0.55,2.0,0.0,2.0,51.0,27.0,24.0,98.0,45.0,53.0,1979
1550,Kevin Loughery,ATL,1,10,82,42,40,82,42,40,728,344,384,0.473,2.0,0.0,2.0,2.0,0.0,2.0,36.0,21.0,15.0,1981
1551,Bill Fitch,BOS,3,12,82,63,19,246,186,60,984,490,494,0.498,12.0,7.0,5.0,38.0,24.0,14.0,56.0,31.0,25.0,1981
1552,Jerry Sloan,CHI,3,3,51,19,32,215,94,121,215,94,121,0.43700000000000006,,,,6.0,2.0,4.0,6.0,2.0,4.0,1981
1553,Phil Johnson,CHI,1,6,1,0,1,1,0,1,342,155,187,0.45299999999999996,,,,,,,6.0,2.0,4.0,1981
1554,Rod Thorn,CHI,1,2,30,15,15,30,15,15,77,35,42,0.455,,,,,,,,,,1981
1555,Don Delaney,CLE,2,2,15,4,11,26,7,19,26,7,19,0.26899999999999996,,,,,,,,,,1981
1556,Bob Kloppenburg,CLE,1,1,3,0,3,3,0,3,3,0,3,0.0,,,,,,,,,,1981
1557,Chuck Daly,CLE,1,1,41,9,32,41,9,32,41,9,32,0.22,,,,,,,,,,1981
1558,Bill Musselman,CLE,2,3,23,2,21,94,27,67,131,34,97,0.26,,,,,,,,,,1981
1559,Dick Motta,DAL,2,14,82,28,54,164,43,121,1148,584,564,0.509,,,,,,,98.0,45.0,53.0,1981
1560,Doug Moe,DEN,2,6,82,46,36,133,72,61,445,249,196,0.56,3.0,1.0,2.0,3.0,1.0,2.0,25.0,10.0,15.0,1981
1561,Scotty Robertson,DET,2,4,82,39,43,164,60,104,205,72,133,0.35100000000000003,,,,,,,,,,1981
1562,Al Attles,GSW,13,13,82,45,37,993,527,466,993,527,466,0.531,,,,61.0,31.0,30.0,61.0,31.0,30.0,1981
1563,Del Harris,HOU,3,3,82,46,36,246,127,119,246,127,119,0.516,3.0,1.0,2.0,31.0,15.0,16.0,31.0,15.0,16.0,1981
1564,Jack McKinney,IND,2,3,82,35,47,164,79,85,178,89,89,0.5,,,,2.0,0.0,2.0,2.0,0.0,2.0,1981
1565,Cotton Fitzsimmons,KCK,4,11,82,30,52,328,165,163,894,429,465,0.48,,,,23.0,9.0,14.0,29.0,11.0,18.0,1981
1566,Paul Westhead,LAL,3,3,11,7,4,161,111,50,161,111,50,0.6890000000000001,,,,19.0,13.0,6.0,19.0,13.0,6.0,1981
1567,Pat Riley,LAL,1,1,71,50,21,71,50,21,71,50,21,0.7040000000000001,14.0,12.0,2.0,14.0,12.0,2.0,14.0,12.0,2.0,1981
1568,Don Nelson,MIL,6,6,82,55,27,474,273,201,474,273,201,0.5760000000000001,6.0,2.0,4.0,29.0,13.0,16.0,29.0,13.0,16.0,1981
1569,Larry Brown,NJN,1,8,82,44,38,82,44,38,635,399,236,0.628,2.0,0.0,2.0,2.0,0.0,2.0,63.0,28.0,35.0,1981
1570,Red Holzman,NYK,14,18,82,33,49,1096,613,483,1299,696,603,0.536,,,,97.0,54.0,43.0,105.0,58.0,47.0,1981
1571,Billy Cunningham,PHI,5,5,82,58,24,404,279,125,404,279,125,0.691,21.0,12.0,9.0,74.0,44.0,30.0,74.0,44.0,30.0,1981
1572,John MacLeod,PHO,9,9,82,46,36,738,395,343,738,395,343,0.535,7.0,2.0,5.0,58.0,27.0,31.0,58.0,27.0,31.0,1981
1573,Jack Ramsay,POR,6,14,82,42,40,492,277,215,1148,609,539,0.53,,,,34.0,19.0,15.0,73.0,33.0,40.0,1981
1574,Stan Albeck,SAS,2,4,82,48,34,164,100,64,317,164,153,0.517,9.0,4.0,5.0,16.0,7.0,9.0,16.0,7.0,9.0,1981
1575,Paul Silas,SDC,2,2,82,17,65,164,53,111,164,53,111,0.32299999999999995,,,,,,,,,,1981
1576,Lenny Wilkens,SEA,8,10,82,52,30,634,357,277,798,432,366,0.541,8.0,3.0,5.0,62.0,35.0,27.0,62.0,35.0,27.0,1981
1577,Tom Nissalke,UTA,3,11,20,8,12,184,60,124,715,320,395,0.44799999999999995,,,,,,,31.0,11.0,20.0,1981
1578,Frank Layden,UTA,1,1,62,17,45,62,17,45,62,17,45,0.27399999999999997,,,,,,,,,,1981
1579,Gene Shue,WSB,9,16,82,43,39,712,373,339,1210,608,602,0.502,7.0,3.0,4.0,47.0,17.0,30.0,69.0,28.0,41.0,1981
1580,Lenny Wilkens,ATL,3,23,82,46,36,246,145,101,1864,1014,850,0.544,10.0,4.0,6.0,24.0,9.0,15.0,134.0,64.0,70.0,1995
1581,M.L. Carr,BOS,1,1,82,33,49,82,33,49,82,33,49,0.402,,,,,,,,,,1995
1582,Allan Bristow,CHH,5,5,82,41,41,410,207,203,410,207,203,0.505,,,,13.0,5.0,8.0,13.0,5.0,8.0,1995
1583,Phil Jackson,CHI,7,7,82,72,10,574,414,160,574,414,160,0.721,18.0,15.0,3.0,112.0,81.0,31.0,112.0,81.0,31.0,1995
1584,Mike Fratello,CLE,3,11,82,47,35,246,137,109,823,461,362,0.56,3.0,0.0,3.0,10.0,1.0,9.0,50.0,19.0,31.0,1995
1585,Dick Motta,DAL,9,24,82,26,56,738,329,409,1883,918,965,0.488,,,,28.0,11.0,17.0,126.0,56.0,70.0,1995
1586,Bernie Bickerstaff,DEN,2,7,82,35,47,114,55,59,524,257,267,0.49,,,,3.0,0.0,3.0,30.0,12.0,18.0,1995
1587,Doug Collins,DET,1,4,82,46,36,82,46,36,328,183,145,0.5579999999999999,3.0,0.0,3.0,3.0,0.0,3.0,33.0,13.0,20.0,1995
1588,Rick Adelman,GSW,1,7,82,36,46,82,36,46,527,327,200,0.62,,,,,,,69.0,36.0,33.0,1995
1589,Rudy Tomjanovich,HOU,5,5,82,48,34,358,224,134,358,224,134,0.626,8.0,3.0,5.0,65.0,39.0,26.0,65.0,39.0,26.0,1995
1590,Larry Brown,IND,3,17,82,52,30,246,151,95,1358,814,544,0.599,5.0,2.0,3.0,38.0,22.0,16.0,125.0,61.0,64.0,1995
1591,Bill Fitch,LAC,2,23,82,29,53,164,46,118,1886,891,995,0.47200000000000003,,,,,,,106.0,55.0,51.0,1995
1592,Del Harris,LAL,2,11,82,53,29,164,101,63,837,433,404,0.517,4.0,1.0,3.0,14.0,6.0,8.0,66.0,27.0,39.0,1995
1593,Pat Riley,MIA,1,14,82,42,40,82,42,40,1137,798,339,0.7020000000000001,3.0,0.0,3.0,3.0,0.0,3.0,215.0,137.0,78.0,1995
1594,Mike Dunleavy,MIL,4,6,82,25,57,328,107,221,492,208,284,0.423,,,,,,,23.0,13.0,10.0,1995
1595,Bill Blair,MIN,2,3,20,6,14,102,27,75,108,29,79,0.26899999999999996,,,,,,,2.0,0.0,2.0,1995
1596,Flip Saunders,MIN,1,1,62,20,42,62,20,42,62,20,42,0.32299999999999995,,,,,,,,,,1995
1597,Butch Beard,NJN,2,2,82,30,52,164,60,104,164,60,104,0.366,,,,,,,,,,1995
1598,Don Nelson,NYK,1,19,59,34,25,59,34,25,1480,851,629,0.575,,,,,,,112.0,51.0,61.0,1995
1599,Jeff Van Gundy,NYK,1,1,23,13,10,23,13,10,23,13,10,0.565,8.0,4.0,4.0,8.0,4.0,4.0,8.0,4.0,4.0,1995
1600,Brian Hill,ORL,3,3,82,60,22,246,167,79,246,167,79,0.679,12.0,7.0,5.0,36.0,18.0,18.0,36.0,18.0,18.0,1995
1601,John Lucas,PHI,2,4,82,18,64,164,42,122,307,136,171,0.44299999999999995,,,,,,,14.0,6.0,8.0,1995
1602,Paul Westphal,PHO,4,4,33,14,19,279,191,88,279,191,88,0.685,,,,44.0,25.0,19.0,44.0,25.0,19.0,1995
1603,Cotton Fitzsimmons,PHO,7,20,49,27,22,541,341,200,1599,832,767,0.52,4.0,1.0,3.0,44.0,22.0,22.0,84.0,35.0,49.0,1995
1604,P.J. Carlesimo,POR,2,2,82,44,38,164,88,76,164,88,76,0.537,5.0,2.0,3.0,8.0,2.0,6.0,8.0,2.0,6.0,1995
1605,Garry St. Jean,SAC,4,4,82,39,43,328,131,197,328,131,197,0.39899999999999997,4.0,1.0,3.0,4.0,1.0,3.0,4.0,1.0,3.0,1995
1606,Bob Hill,SAS,2,6,82,59,23,164,121,43,451,254,197,0.563,10.0,5.0,5.0,25.0,14.0,11.0,37.0,17.0,20.0,1995
1607,George Karl,SEA,5,9,82,64,18,370,266,104,665,385,280,0.579,21.0,13.0,8.0,58.0,30.0,28.0,72.0,35.0,37.0,1995
1608,Brendan Malone,TOR,1,1,82,21,61,82,21,61,82,21,61,0.256,,,,,,,,,,1995
1609,Jerry Sloan,UTA,8,11,82,55,27,639,419,220,854,513,341,0.601,18.0,10.0,8.0,77.0,37.0,40.0,83.0,39.0,44.0,1995
1610,Brian Winters,VAN,1,1,82,15,67,82,15,67,82,15,67,0.183,,,,,,,,,,1995
1611,Jim Lynam,WSB,2,9,82,39,43,164,60,104,674,306,368,0.45399999999999996,,,,,,,21.0,8.0,13.0,1995
1612,Clair Bee,BLB,2,2,72,16,56,139,32,107,139,32,107,0.23,,,,2.0,0.0,2.0,2.0,0.0,2.0,1953
1613,Red Auerbach,BOS,4,8,72,42,30,278,166,112,503,309,194,0.614,6.0,2.0,4.0,17.0,6.0,11.0,37.0,15.0,22.0,1953
1614,Paul Birch,FTW,3,4,72,40,32,207,105,102,267,120,147,0.449,4.0,0.0,4.0,14.0,4.0,10.0,14.0,4.0,10.0,1953
1615,Andrew Levane,MLH,2,2,46,11,35,117,38,79,117,38,79,0.325,,,,,,,,,,1953
1616,Red Holzman,MLH,1,1,26,10,16,26,10,16,26,10,16,0.385,,,,,,,,,,1953
1617,John Kundla,MNL,6,6,72,46,26,404,273,131,404,273,131,0.6759999999999999,13.0,9.0,4.0,67.0,48.0,19.0,67.0,48.0,19.0,1953
1618,Joe Lapchick,NYK,7,7,72,44,28,450,262,188,450,262,188,0.5820000000000001,4.0,0.0,4.0,57.0,29.0,28.0,57.0,29.0,28.0,1953
1619,Edward Gottlieb,PHW,8,8,72,29,43,509,230,279,509,230,279,0.452,,,,32.0,15.0,17.0,32.0,15.0,17.0,1953
1620,Les Harrison,ROC,6,6,72,44,28,404,266,138,404,266,138,0.6579999999999999,6.0,3.0,3.0,35.0,18.0,17.0,35.0,18.0,17.0,1953
1621,Al Cervi,SYR,5,5,72,42,30,339,212,127,339,212,127,0.625,13.0,9.0,4.0,40.0,22.0,18.0,40.0,22.0,18.0,1953
1622,Red Auerbach,BOS,5,9,72,36,36,350,202,148,575,345,230,0.6,7.0,3.0,4.0,24.0,9.0,15.0,44.0,18.0,26.0,1954
1623,Charles Eckman,FTW,1,1,72,43,29,72,43,29,72,43,29,0.597,11.0,6.0,5.0,11.0,6.0,5.0,11.0,6.0,5.0,1954
1624,Red Holzman,MLH,2,2,72,26,46,98,36,62,98,36,62,0.36700000000000005,,,,,,,,,,1954
1625,John Kundla,MNL,7,7,72,40,32,476,313,163,476,313,163,0.6579999999999999,7.0,3.0,4.0,74.0,51.0,23.0,74.0,51.0,23.0,1954
1626,Joe Lapchick,NYK,8,8,72,38,34,522,300,222,522,300,222,0.575,3.0,1.0,2.0,60.0,30.0,30.0,60.0,30.0,30.0,1954
1627,Edward Gottlieb,PHW,9,9,72,33,39,581,263,318,581,263,318,0.45299999999999996,,,,32.0,15.0,17.0,32.0,15.0,17.0,1954
1628,Les Harrison,ROC,7,7,72,29,43,476,295,181,476,295,181,0.62,3.0,1.0,2.0,38.0,19.0,19.0,38.0,19.0,19.0,1954
1629,Al Cervi,SYR,6,6,72,43,29,411,255,156,411,255,156,0.62,11.0,7.0,4.0,51.0,29.0,22.0,51.0,29.0,22.0,1954
1630,Lon Kruger,ATL,2,2,82,33,49,164,58,106,164,58,106,0.354,,,,,,,,,,2001
1631,Jim O'Brien,BOS,2,2,82,49,33,130,73,57,130,73,57,0.562,16.0,9.0,7.0,16.0,9.0,7.0,16.0,9.0,7.0,2001
1632,Paul Silas,CHH,4,7,82,44,38,281,161,120,527,239,288,0.45399999999999996,9.0,4.0,5.0,23.0,11.0,12.0,23.0,11.0,12.0,2001
1633,Tim Floyd,CHI,4,4,25,4,21,239,49,190,239,49,190,0.205,,,,,,,,,,2001
1634,Bill Berry,CHI,1,1,2,0,2,2,0,2,2,0,2,0.0,,,,,,,,,,2001
1635,Bill Cartwright,CHI,1,1,55,17,38,55,17,38,55,17,38,0.309,,,,,,,,,,2001
1636,John Lucas,CLE,1,5,82,29,53,82,29,53,389,165,224,0.424,,,,,,,14.0,6.0,8.0,2001
1637,Don Nelson,DAL,5,24,82,57,25,362,185,177,1842,1036,806,0.562,8.0,4.0,4.0,18.0,8.0,10.0,130.0,59.0,71.0,2001
1638,Dan Issel,DEN,6,6,26,9,17,388,180,208,388,180,208,0.46399999999999997,,,,12.0,6.0,6.0,12.0,6.0,6.0,2001
1639,Mike Evans,DEN,1,1,56,18,38,56,18,38,56,18,38,0.321,,,,,,,,,,2001
1640,Rick Carlisle,DET,1,1,82,50,32,82,50,32,82,50,32,0.61,10.0,4.0,6.0,10.0,4.0,6.0,10.0,4.0,6.0,2001
1641,Dave Cowens,GSW,2,6,23,8,15,105,25,80,352,161,191,0.457,,,,,,,12.0,4.0,8.0,2001
1642,Brian Winters,GSW,1,3,59,13,46,59,13,46,184,36,148,0.196,,,,,,,,,,2001
1643,Rudy Tomjanovich,HOU,11,11,82,28,54,818,460,358,818,460,358,0.562,,,,90.0,51.0,39.0,90.0,51.0,39.0,2001
1644,Isiah Thomas,IND,2,2,82,42,40,164,83,81,164,83,81,0.506,5.0,2.0,3.0,9.0,3.0,6.0,9.0,3.0,6.0,2001
1645,Alvin Gentry,LAC,2,6,82,39,43,164,70,94,345,158,187,0.45799999999999996,,,,,,,5.0,2.0,3.0,2001
1646,Phil Jackson,LAL,3,12,82,58,24,246,181,65,984,726,258,0.738,19.0,15.0,4.0,58.0,45.0,13.0,210.0,156.0,54.0,2001
1647,Sidney Lowe,MEM,2,4,82,23,59,164,46,118,299,79,220,0.264,,,,,,,,,,2001
1648,Pat Riley,MIA,7,20,82,36,46,542,329,213,1597,1085,512,0.679,,,,43.0,18.0,25.0,255.0,155.0,100.0,2001
1649,George Karl,MIL,4,15,82,41,41,296,163,133,1125,666,459,0.5920000000000001,,,,26.0,12.0,14.0,120.0,57.0,63.0,2001
1650,Flip Saunders,MIN,7,7,82,50,32,522,277,245,522,277,245,0.531,3.0,0.0,3.0,23.0,5.0,18.0,23.0,5.0,18.0,2001
1651,Byron Scott,NJN,2,2,82,52,30,164,78,86,164,78,86,0.47600000000000003,20.0,11.0,9.0,20.0,11.0,9.0,20.0,11.0,9.0,2001
1652,Jeff Van Gundy,NYK,7,7,19,10,9,420,248,172,420,248,172,0.59,,,,69.0,37.0,32.0,69.0,37.0,32.0,2001
1653,Don Chaney,NYK,1,10,63,20,43,63,20,43,710,285,425,0.401,,,,,,,11.0,2.0,9.0,2001
1654,Doc Rivers,ORL,3,3,82,44,38,246,128,118,246,128,118,0.52,4.0,1.0,3.0,8.0,2.0,6.0,8.0,2.0,6.0,2001
1655,Larry Brown,PHI,5,23,82,43,39,378,207,171,1818,1060,758,0.583,5.0,2.0,3.0,46.0,22.0,24.0,171.0,83.0,88.0,2001
1656,Scott Skiles,PHO,3,3,51,25,26,195,116,79,195,116,79,0.595,,,,13.0,5.0,8.0,13.0,5.0,8.0,2001
1657,Frank Johnson,PHO,1,1,31,11,20,31,11,20,31,11,20,0.355,,,,,,,,,,2001
1658,Maurice Cheeks,POR,1,1,82,49,33,82,49,33,82,49,33,0.598,3.0,0.0,3.0,3.0,0.0,3.0,3.0,0.0,3.0,2001
1659,Rick Adelman,SAC,4,12,82,61,21,296,187,109,905,544,361,0.601,16.0,10.0,6.0,34.0,17.0,17.0,103.0,53.0,50.0,2001
1660,Gregg Popovich,SAS,6,6,82,58,24,442,279,163,442,279,163,0.631,10.0,4.0,6.0,53.0,31.0,22.0,53.0,31.0,22.0,2001
1661,Nate McMillan,SEA,2,2,82,45,37,149,83,66,149,83,66,0.557,5.0,2.0,3.0,5.0,2.0,3.0,5.0,2.0,3.0,2001
1662,Lenny Wilkens,TOR,2,29,82,42,40,164,89,75,2324,1268,1056,0.546,5.0,2.0,3.0,17.0,8.0,9.0,174.0,80.0,94.0,2001
1663,Jerry Sloan,UTA,14,17,82,44,38,1099,734,365,1314,828,486,0.63,4.0,1.0,3.0,147.0,75.0,72.0,153.0,77.0,76.0,2001
1664,Doug Collins,WAS,1,7,82,37,45,82,37,45,537,295,242,0.5489999999999999,,,,,,,38.0,15.0,23.0,2001
1665,Mike Fratello,ATL,4,4,82,50,32,249,124,125,249,124,125,0.498,9.0,4.0,5.0,14.0,6.0,8.0,14.0,6.0,8.0,1985
1666,K.C. Jones,BOS,3,7,82,67,15,246,192,54,576,377,199,0.655,18.0,15.0,3.0,62.0,43.0,19.0,97.0,57.0,40.0,1985
1667,Stan Albeck,CHI,1,8,82,30,52,82,30,52,645,334,311,0.518,3.0,0.0,3.0,3.0,0.0,3.0,44.0,18.0,26.0,1985
1668,George Karl,CLE,2,2,67,25,42,149,61,88,149,61,88,0.409,,,,4.0,1.0,3.0,4.0,1.0,3.0,1985
1669,Gene Littles,CLE,1,1,15,4,11,15,4,11,15,4,11,0.267,,,,,,,,,,1985
1670,Dick Motta,DAL,6,18,82,44,38,492,212,280,1476,753,723,0.51,10.0,5.0,5.0,24.0,10.0,14.0,122.0,55.0,67.0,1985
1671,Doug Moe,DEN,6,10,82,47,35,461,254,207,773,431,342,0.5579999999999999,10.0,5.0,5.0,41.0,19.0,22.0,63.0,28.0,35.0,1985
1672,Chuck Daly,DET,3,4,82,46,36,246,141,105,287,150,137,0.523,4.0,1.0,3.0,18.0,8.0,10.0,18.0,8.0,10.0,1985
1673,Johnny Bach,GSW,4,4,82,30,52,267,95,172,267,95,172,0.35600000000000004,,,,,,,,,,1985
1674,Bill Fitch,HOU,3,16,82,51,31,246,128,118,1312,674,638,0.514,20.0,13.0,7.0,25.0,15.0,10.0,88.0,48.0,40.0,1985
1675,George Irvine,IND,2,2,82,26,56,164,48,116,164,48,116,0.293,,,,,,,,,,1985
1676,Don Chaney,LAC,2,2,82,32,50,103,41,62,103,41,62,0.39799999999999996,,,,,,,,,,1985
1677,Pat Riley,LAL,5,5,82,62,20,399,286,113,399,286,113,0.7170000000000001,14.0,8.0,6.0,83.0,57.0,26.0,83.0,57.0,26.0,1985
1678,Don Nelson,MIL,10,10,82,57,25,802,490,312,802,490,312,0.611,14.0,7.0,7.0,76.0,36.0,40.0,76.0,36.0,40.0,1985
1679,Dave Wohl,NJN,1,1,82,39,43,82,39,43,82,39,43,0.47600000000000003,3.0,0.0,3.0,3.0,0.0,3.0,3.0,0.0,3.0,1985
1680,Hubie Brown,NYK,4,11,82,23,59,328,138,190,903,441,462,0.488,,,,18.0,8.0,10.0,59.0,31.0,28.0,1985
1681,Matt Guokas,PHI,1,1,82,54,28,82,54,28,82,54,28,0.659,12.0,6.0,6.0,12.0,6.0,6.0,12.0,6.0,6.0,1985
1682,John MacLeod,PHO,13,13,82,32,50,1066,557,509,1066,557,509,0.523,,,,81.0,37.0,44.0,81.0,37.0,44.0,1985
1683,Jack Ramsay,POR,10,18,82,40,42,820,453,367,1476,785,691,0.532,4.0,1.0,3.0,59.0,29.0,30.0,98.0,43.0,55.0,1985
1684,Phil Johnson,SAC,7,8,82,37,45,496,222,274,497,222,275,0.447,3.0,0.0,3.0,9.0,2.0,7.0,9.0,2.0,7.0,1985
1685,Cotton Fitzsimmons,SAS,2,15,82,35,47,164,76,88,1222,588,634,0.48100000000000004,3.0,0.0,3.0,8.0,2.0,6.0,40.0,13.0,27.0,1985
1686,Bernie Bickerstaff,SEA,1,1,82,31,51,82,31,51,82,31,51,0.37799999999999995,,,,,,,,,,1985
1687,Frank Layden,UTA,5,5,82,42,40,390,175,215,390,175,215,0.449,4.0,1.0,3.0,25.0,10.0,15.0,25.0,10.0,15.0,1985
1688,Gene Shue,WSB,13,20,69,32,37,1027,522,505,1525,757,768,0.496,,,,55.0,19.0,36.0,77.0,30.0,47.0,1985
1689,Kevin Loughery,WSB,1,14,13,7,6,13,7,6,987,459,528,0.465,5.0,2.0,3.0,5.0,2.0,3.0,48.0,25.0,23.0,1985
