,Unnamed: 0,Coach,Team,numSznsWTeam,numTotSzns,curr_games,curr_wins,curr_losses,franch_games,franch_wins,franch_losses,tot_games,tot_wins,tot_losses,win_percent,curr_pl_games,curr_pl_wins,curr_pl_losses,franch_pl_games,franch_pl_wins,franch_pl_losses,tot_pl_games,tot_pl_wins,tot_pl_losses,Season,pl_win_percent,Seasons
0,0,Red Auerbach,BOS,13,17,80,58,22,952,620,332,1177,763,414,0.648,13.0,8.0,5.0,109.0,63.0,46.0,129.0,72.0,57.0,1962,0.6153846153846154,1959-69
1,1,Jack McMahon,WAS,1,1,38,12,26,38,12,26,38,12,26,0.316,,,,,,,,,,1962,,1959-69
9,9,Alex Hannum,PHI,3,5,80,48,32,239,127,112,342,183,159,0.535,5.0,2.0,3.0,18.0,8.0,10.0,39.0,22.0,17.0,1962,0.4,1959-69
10,10,Richie Guerin,ATL,7,7,82,36,46,536,291,245,536,291,245,0.5429999999999999,5.0,1.0,4.0,54.0,24.0,30.0,54.0,24.0,30.0,1970,0.2,1969-1979
11,11,Gene Shue,WAS,5,5,82,42,40,384,201,183,384,201,183,0.523,18.0,8.0,10.0,29.0,11.0,18.0,29.0,11.0,18.0,1970,0.4444444444444444,1969-1979
12,12,Tom Heinsohn,BOS,2,2,82,44,38,164,78,86,164,78,86,0.476,,,,,,,,,,1970,,1969-1979
14,14,Dick Motta,CHI,3,3,82,51,31,246,123,123,246,123,123,0.5,7.0,3.0,4.0,12.0,4.0,8.0,12.0,4.0,8.0,1970,0.42857142857142855,1969-1979
16,16,Bill Fitch,CLE,1,1,82,15,67,82,15,67,82,15,67,0.183,,,,,,,,,,1970,,1969-1979
17,17,Butch van Breda Kolff,DET,2,4,82,45,37,164,76,88,328,183,145,0.5579999999999999,,,,,,,33.0,21.0,12.0,1970,,1969-1979
19,19,Larry Costello,MIL,3,3,82,66,16,246,149,97,246,149,97,0.606,14.0,12.0,2.0,24.0,17.0,7.0,24.0,17.0,7.0,1970,0.8571428571428571,1969-1979
20,20,Red Holzman,NYK,4,8,82,52,30,290,194,96,493,277,216,0.562,12.0,7.0,5.0,47.0,27.0,20.0,55.0,31.0,24.0,1970,0.5833333333333334,1969-1979
21,21,Jack Ramsay,PHI,3,3,82,47,35,246,144,102,246,144,102,0.585,7.0,3.0,4.0,17.0,5.0,12.0,17.0,5.0,12.0,1970,0.42857142857142855,1969-1979
22,22,Cotton Fitzsimmons,PHO,1,1,82,48,34,82,48,34,82,48,34,0.585,,,,,,,,,,1970,,1969-1979
24,24,Alex Hannum,HOU,2,13,82,40,42,138,58,80,961,531,430,0.5529999999999999,,,,,,,95.0,57.0,38.0,1970,,1969-1979
25,25,Lenny Wilkens,OKC,2,2,82,38,44,164,74,90,164,74,90,0.451,,,,,,,,,,1970,,1969-1979
26,26,Al Attles,GSW,2,2,82,41,41,112,49,63,112,49,63,0.438,5.0,1.0,4.0,5.0,1.0,4.0,5.0,1.0,4.0,1970,0.2,1969-1979
28,28,Terry Stotts,ATL,1,1,55,24,31,55,24,31,55,24,31,0.436,,,,,,,,,,2002,,1998-2008
29,29,Jim O'Brien,BOS,3,3,82,44,38,212,117,95,212,117,95,0.552,10.0,4.0,6.0,26.0,13.0,13.0,26.0,13.0,13.0,2002,0.4,1998-2008
33,33,Don Nelson,DAL,6,25,82,60,22,444,245,199,1924,1096,828,0.57,20.0,10.0,10.0,38.0,18.0,20.0,150.0,69.0,81.0,2002,0.5,1998-2008
35,35,Rick Carlisle,DET,2,2,82,50,32,164,100,64,164,100,64,0.61,17.0,8.0,9.0,27.0,12.0,15.0,27.0,12.0,15.0,2002,0.47058823529411764,1998-2008
37,37,Rudy Tomjanovich,HOU,12,12,82,43,39,900,503,397,900,503,397,0.5589999999999999,,,,90.0,51.0,39.0,90.0,51.0,39.0,2002,,1998-2008
39,39,Alvin Gentry,LAC,3,7,58,19,39,222,89,133,403,177,226,0.439,,,,,,,5.0,2.0,3.0,2002,,1998-2008
41,41,Phil Jackson,LAL,4,13,82,50,32,328,231,97,1066,776,290,0.728,12.0,6.0,6.0,70.0,51.0,19.0,222.0,162.0,60.0,2002,0.5,1998-2008
43,43,Hubie Brown,MEM,1,13,74,28,46,74,28,46,993,473,520,0.476,,,,,,,59.0,31.0,28.0,2002,,1998-2008
44,44,Pat Riley,MIA,8,21,82,25,57,624,354,270,1679,1110,569,0.6609999999999999,,,,43.0,18.0,25.0,255.0,155.0,100.0,2002,,1998-2008
45,45,George Karl,MIL,5,16,82,42,40,378,205,173,1207,708,499,0.5870000000000001,6.0,2.0,4.0,32.0,14.0,18.0,126.0,59.0,67.0,2002,0.3333333333333333,1998-2008
46,46,Flip Saunders,MIN,8,8,82,51,31,604,328,276,604,328,276,0.5429999999999999,6.0,2.0,4.0,29.0,7.0,22.0,29.0,7.0,22.0,2002,0.3333333333333333,1998-2008
47,47,Byron Scott,BRK,3,3,82,49,33,246,127,119,246,127,119,0.516,20.0,14.0,6.0,40.0,25.0,15.0,40.0,25.0,15.0,2002,0.7,1998-2008
48,48,Paul Silas,NOP,1,8,82,47,35,82,47,35,609,286,323,0.47,6.0,2.0,4.0,6.0,2.0,4.0,29.0,13.0,16.0,2002,0.3333333333333333,1998-2008
49,49,Don Chaney,NYK,2,11,82,37,45,145,57,88,792,322,470,0.407,,,,,,,11.0,2.0,9.0,2002,,1998-2008
50,50,Doc Rivers,ORL,4,4,82,42,40,328,170,158,328,170,158,0.518,7.0,3.0,4.0,15.0,5.0,10.0,15.0,5.0,10.0,2002,0.42857142857142855,1998-2008
51,51,Larry Brown,PHI,6,24,82,48,34,460,255,205,1900,1108,792,0.583,12.0,6.0,6.0,58.0,28.0,30.0,183.0,89.0,94.0,2002,0.5,1998-2008
53,53,Maurice Cheeks,POR,2,2,82,50,32,164,99,65,164,99,65,0.604,7.0,3.0,4.0,10.0,3.0,7.0,10.0,3.0,7.0,2002,0.42857142857142855,1998-2008
54,54,Rick Adelman,SAC,5,13,82,59,23,378,246,132,987,603,384,0.611,12.0,7.0,5.0,46.0,24.0,22.0,115.0,60.0,55.0,2002,0.5833333333333334,1998-2008
55,55,Gregg Popovich,SAS,7,7,82,60,22,524,339,185,524,339,185,0.647,24.0,16.0,8.0,77.0,47.0,30.0,77.0,47.0,30.0,2002,0.6666666666666666,1998-2008
56,56,Nate McMillan,OKC,3,3,82,40,42,231,123,108,231,123,108,0.532,,,,5.0,2.0,3.0,5.0,2.0,3.0,2002,,1998-2008
57,57,Lenny Wilkens,TOR,3,30,82,24,58,246,113,133,2406,1292,1114,0.537,,,,17.0,8.0,9.0,174.0,80.0,94.0,2002,,1998-2008
58,58,Jerry Sloan,UTA,15,18,82,47,35,1181,781,400,1396,875,521,0.627,5.0,1.0,4.0,152.0,76.0,76.0,158.0,78.0,80.0,2002,0.2,1998-2008
59,59,Doug Collins,WAS,2,8,82,37,45,164,74,90,619,332,287,0.536,,,,,,,38.0,15.0,23.0,2002,,1998-2008
60,60,Lenny Wilkens,ATL,1,21,82,57,25,82,57,25,1700,926,774,0.545,11.0,5.0,6.0,11.0,5.0,6.0,121.0,60.0,61.0,1993,0.45454545454545453,1988-1998
61,61,Chris Ford,BOS,4,4,82,32,50,328,187,141,328,187,141,0.57,,,,25.0,12.0,13.0,25.0,12.0,13.0,1993,,1988-1998
63,63,Phil Jackson,CHI,5,5,82,55,27,410,295,115,410,295,115,0.72,10.0,6.0,4.0,84.0,61.0,23.0,84.0,61.0,23.0,1993,0.6,1988-1998
64,64,Mike Fratello,CLE,1,9,82,47,35,82,47,35,659,371,288,0.563,3.0,0.0,3.0,3.0,0.0,3.0,43.0,18.0,25.0,1993,0.0,1988-1998
67,67,Don Chaney,DET,1,8,82,20,62,82,20,62,565,237,328,0.419,,,,,,,11.0,2.0,9.0,1993,,1988-1998
68,68,Don Nelson,GSW,6,17,82,50,32,492,263,229,1376,803,573,0.584,3.0,0.0,3.0,24.0,9.0,15.0,112.0,51.0,61.0,1993,0.0,1988-1998
69,69,Rudy Tomjanovich,HOU,3,3,82,58,24,194,129,65,194,129,65,0.665,23.0,15.0,8.0,35.0,21.0,14.0,35.0,21.0,14.0,1993,0.6521739130434783,1988-1998
70,70,Larry Brown,IND,1,15,82,47,35,82,47,35,1194,710,484,0.595,16.0,10.0,6.0,16.0,10.0,6.0,103.0,49.0,54.0,1993,0.625,1988-1998
75,75,Kevin Loughery,MIA,3,19,82,42,40,246,116,130,1342,625,717,0.466,5.0,2.0,3.0,8.0,2.0,6.0,59.0,27.0,32.0,1993,0.4,1988-1998
76,76,Mike Dunleavy,MIL,2,4,82,20,62,164,48,116,328,149,179,0.454,,,,,,,23.0,13.0,10.0,1993,,1988-1998
78,78,Chuck Daly,BRK,2,12,82,45,37,164,88,76,943,564,379,0.598,4.0,1.0,3.0,9.0,3.0,6.0,122.0,74.0,48.0,1993,0.25,1988-1998
79,79,Pat Riley,NYK,3,12,82,57,25,246,168,78,973,701,272,0.72,25.0,14.0,11.0,52.0,29.0,23.0,201.0,131.0,70.0,1993,0.56,1988-1998
80,80,Brian Hill,ORL,1,1,82,50,32,82,50,32,82,50,32,0.61,3.0,0.0,3.0,3.0,0.0,3.0,3.0,0.0,3.0,1993,0.0,1988-1998
82,82,Paul Westphal,PHO,2,2,82,56,26,164,118,46,164,118,46,0.72,10.0,6.0,4.0,34.0,19.0,15.0,34.0,19.0,15.0,1993,0.6,1988-1998
83,83,Rick Adelman,POR,6,6,82,47,35,445,291,154,445,291,154,0.654,4.0,1.0,3.0,69.0,36.0,33.0,69.0,36.0,33.0,1993,0.25,1988-1998
86,86,George Karl,OKC,3,7,82,63,19,206,145,61,501,264,237,0.527,5.0,2.0,3.0,33.0,16.0,17.0,47.0,21.0,26.0,1993,0.4,1988-1998
87,87,Jerry Sloan,UTA,6,9,82,53,29,475,304,171,690,398,292,0.5770000000000001,16.0,8.0,8.0,54.0,25.0,29.0,60.0,27.0,33.0,1993,0.5,1988-1998
89,89,Lenny Wilkens,ATL,6,26,50,31,19,460,282,178,2078,1151,927,0.5539999999999999,9.0,3.0,6.0,47.0,17.0,30.0,157.0,72.0,85.0,1998,0.3333333333333333,1988-1998
92,92,Paul Silas,NOP,1,4,35,22,13,35,22,13,281,100,181,0.35600000000000004,,,,,,,,,,1998,,1988-1998
94,94,Mike Fratello,CLE,6,14,50,22,28,460,248,212,1037,572,465,0.552,,,,14.0,2.0,12.0,54.0,20.0,34.0,1998,,1988-1998
95,95,Don Nelson,DAL,2,21,50,19,31,116,35,81,1596,886,710,0.555,,,,,,,112.0,51.0,61.0,1998,,1988-1998
96,96,Mike D'Antoni,DEN,1,1,50,14,36,50,14,36,50,14,36,0.28,,,,,,,,,,1998,,1988-1998
97,97,Alvin Gentry,DET,2,3,50,29,21,87,45,42,123,60,63,0.488,5.0,2.0,3.0,5.0,2.0,3.0,5.0,2.0,3.0,1998,0.4,1988-1998
98,98,P.J. Carlesimo,GSW,2,5,50,21,29,132,40,92,378,177,201,0.468,,,,,,,12.0,3.0,9.0,1998,,1988-1998
99,99,Rudy Tomjanovich,HOU,8,8,50,31,19,572,353,219,572,353,219,0.617,4.0,1.0,3.0,90.0,51.0,39.0,90.0,51.0,39.0,1998,0.25,1988-1998
101,101,Chris Ford,LAC,1,8,50,9,41,50,9,41,624,300,324,0.481,,,,,,,29.0,13.0,16.0,1998,,1988-1998
102,102,Del Harris,LAL,5,14,12,6,6,340,224,116,1013,556,457,0.5489999999999999,,,,36.0,17.0,19.0,88.0,38.0,50.0,1998,,1988-1998
105,105,Pat Riley,MIA,4,17,50,33,17,296,191,105,1351,947,404,0.701,5.0,2.0,3.0,30.0,12.0,18.0,242.0,149.0,93.0,1998,0.4,1988-1998
106,106,George Karl,MIL,1,12,50,28,22,50,28,22,879,531,348,0.604,3.0,0.0,3.0,3.0,0.0,3.0,97.0,45.0,52.0,1998,0.0,1988-1998
107,107,Flip Saunders,MIN,4,4,50,25,25,276,130,146,276,130,146,0.471,4.0,1.0,3.0,12.0,3.0,9.0,12.0,3.0,9.0,1998,0.25,1988-1998
110,110,Jeff Van Gundy,NYK,4,4,50,27,23,237,140,97,237,140,97,0.591,20.0,12.0,8.0,48.0,26.0,22.0,48.0,26.0,22.0,1998,0.6,1988-1998
111,111,Chuck Daly,ORL,2,14,50,33,17,132,74,58,1075,638,437,0.593,4.0,1.0,3.0,4.0,1.0,3.0,126.0,75.0,51.0,1998,0.25,1988-1998
112,112,Larry Brown,PHI,2,20,50,28,22,132,59,73,1572,912,660,0.58,8.0,3.0,5.0,8.0,3.0,5.0,133.0,64.0,69.0,1998,0.375,1988-1998
114,114,Mike Dunleavy,POR,2,8,50,35,15,132,81,51,624,289,335,0.463,13.0,7.0,6.0,17.0,8.0,9.0,40.0,21.0,19.0,1998,0.5384615384615384,1988-1998
115,115,Rick Adelman,SAC,1,9,50,27,23,50,27,23,659,384,275,0.583,5.0,2.0,3.0,5.0,2.0,3.0,74.0,38.0,36.0,1998,0.4,1988-1998
116,116,Gregg Popovich,SAS,3,3,50,37,13,196,110,86,196,110,86,0.561,17.0,15.0,2.0,26.0,19.0,7.0,26.0,19.0,7.0,1998,0.8823529411764706,1988-1998
117,117,Paul Westphal,OKC,1,5,50,25,25,50,25,25,329,216,113,0.657,,,,,,,44.0,25.0,19.0,1998,,1988-1998
119,119,Jerry Sloan,UTA,11,14,50,37,13,853,582,271,1068,676,392,0.633,11.0,5.0,6.0,128.0,68.0,60.0,134.0,70.0,64.0,1998,0.45454545454545453,1988-1998
120,120,Brian Hill,MEM,2,6,50,8,42,132,27,105,427,218,209,0.511,,,,,,,36.0,18.0,18.0,1998,,1988-1998
121,121,Bernie Bickerstaff,WAS,3,10,32,13,19,149,77,72,686,338,348,0.493,,,,3.0,0.0,3.0,33.0,12.0,21.0,1998,,1988-1998
131,131,Rick Carlisle,DAL,11,17,82,33,49,886,470,416,1378,751,627,0.545,,,,58.0,28.0,30.0,120.0,58.0,62.0,2018,,2008-2018
133,133,Dwane Casey,DET,1,10,82,41,41,82,41,41,762,414,348,0.5429999999999999,4.0,0.0,4.0,4.0,0.0,4.0,55.0,21.0,34.0,2018,0.0,2008-2018
135,135,Mike D'Antoni,HOU,3,15,82,53,29,246,173,73,1127,628,499,0.557,11.0,6.0,5.0,39.0,23.0,16.0,98.0,49.0,49.0,2018,0.5454545454545454,2008-2018
136,136,Nate McMillan,IND,3,15,82,48,34,246,138,108,1176,616,560,0.524,4.0,0.0,4.0,15.0,3.0,12.0,49.0,17.0,32.0,2018,0.0,2008-2018
137,137,Doc Rivers,LAC,6,20,82,48,34,492,307,185,1552,894,658,0.5760000000000001,6.0,2.0,4.0,46.0,20.0,26.0,167.0,84.0,83.0,2018,0.3333333333333333,2008-2018
140,140,Erik Spoelstra,MIA,11,11,82,39,43,886,523,363,886,523,363,0.59,,,,118.0,71.0,47.0,118.0,71.0,47.0,2018,,2008-2018
142,142,Tom Thibodeau,MIN,3,8,40,19,21,204,97,107,598,352,246,0.589,,,,5.0,1.0,4.0,56.0,24.0,32.0,2018,,2008-2018
144,144,Alvin Gentry,NOP,4,16,82,33,49,328,145,183,1033,480,553,0.465,,,,9.0,5.0,4.0,30.0,17.0,13.0,2018,,2008-2018
150,150,Terry Stotts,POR,7,11,82,53,29,574,325,249,857,440,417,0.513,16.0,8.0,8.0,51.0,19.0,32.0,56.0,20.0,36.0,2018,0.5,2008-2018
152,152,Gregg Popovich,SAS,23,23,82,48,34,1820,1245,575,1820,1245,575,0.684,7.0,3.0,4.0,284.0,170.0,114.0,284.0,170.0,114.0,2018,0.42857142857142855,2008-2018
155,155,Scott Brooks,WAS,3,10,82,32,50,246,124,122,791,462,329,0.584,,,,19.0,9.0,10.0,92.0,48.0,44.0,2018,,2008-2018
156,156,Lenny Wilkens,ATL,5,25,82,50,32,410,251,159,2028,1120,908,0.552,4.0,1.0,3.0,38.0,14.0,24.0,148.0,69.0,79.0,1997,0.25,1988-1998
159,159,Phil Jackson,CHI,9,9,82,62,20,738,545,193,738,545,193,0.738,21.0,15.0,6.0,152.0,111.0,41.0,152.0,111.0,41.0,1997,0.7142857142857143,1988-1998
160,160,Mike Fratello,CLE,5,13,82,47,35,410,226,184,987,550,437,0.557,4.0,1.0,3.0,14.0,2.0,12.0,54.0,20.0,34.0,1997,0.25,1988-1998
162,162,Don Nelson,DAL,1,20,66,16,50,66,16,50,1546,867,679,0.561,,,,,,,112.0,51.0,61.0,1997,,1988-1998
164,164,Doug Collins,DET,3,6,45,21,24,209,121,88,455,258,197,0.5670000000000001,,,,8.0,2.0,6.0,38.0,15.0,23.0,1997,,1988-1998
165,165,Alvin Gentry,DET,1,2,37,16,21,37,16,21,73,31,42,0.425,,,,,,,,,,1997,,1988-1998
166,166,P.J. Carlesimo,GSW,1,4,82,19,63,82,19,63,328,156,172,0.476,,,,,,,12.0,3.0,9.0,1997,,1988-1998
167,167,Rudy Tomjanovich,HOU,7,7,82,41,41,522,322,200,522,322,200,0.617,5.0,2.0,3.0,86.0,50.0,36.0,86.0,50.0,36.0,1997,0.4,1988-1998
169,169,Bill Fitch,LAC,4,25,82,17,65,328,99,229,2050,944,1106,0.46,,,,3.0,0.0,3.0,109.0,55.0,54.0,1997,,1988-1998
170,170,Del Harris,LAL,4,13,82,61,21,328,218,110,1001,550,451,0.5489999999999999,13.0,7.0,6.0,36.0,17.0,19.0,88.0,38.0,50.0,1997,0.5384615384615384,1988-1998
171,171,Pat Riley,MIA,3,16,82,55,27,246,158,88,1301,914,387,0.703,5.0,2.0,3.0,25.0,10.0,15.0,237.0,147.0,90.0,1997,0.4,1988-1998
172,172,Chris Ford,MIL,2,7,82,36,46,164,69,95,574,291,283,0.507,,,,,,,29.0,13.0,16.0,1997,,1988-1998
173,173,Flip Saunders,MIN,3,3,82,45,37,226,105,121,226,105,121,0.465,5.0,2.0,3.0,8.0,2.0,6.0,8.0,2.0,6.0,1997,0.4,1988-1998
175,175,Jeff Van Gundy,NYK,3,3,82,43,39,187,113,74,187,113,74,0.604,10.0,4.0,6.0,28.0,14.0,14.0,28.0,14.0,14.0,1997,0.4,1988-1998
176,176,Chuck Daly,ORL,1,13,82,41,41,82,41,41,1025,605,420,0.59,,,,,,,122.0,74.0,48.0,1997,,1988-1998
177,177,Larry Brown,PHI,1,19,82,31,51,82,31,51,1522,884,638,0.581,,,,,,,125.0,61.0,64.0,1997,,1988-1998
179,179,Mike Dunleavy,POR,1,7,82,46,36,82,46,36,574,254,320,0.443,4.0,1.0,3.0,4.0,1.0,3.0,27.0,14.0,13.0,1997,0.25,1988-1998
180,180,Eddie Jordan,SAC,2,2,82,27,55,97,33,64,97,33,64,0.34,,,,,,,,,,1997,,1988-1998
181,181,Gregg Popovich,SAS,2,2,82,56,26,146,73,73,146,73,73,0.5,9.0,4.0,5.0,9.0,4.0,5.0,9.0,4.0,5.0,1997,0.4444444444444444,1988-1998
182,182,George Karl,OKC,7,11,82,61,21,534,384,150,829,503,326,0.607,10.0,4.0,6.0,80.0,40.0,40.0,94.0,45.0,49.0,1997,0.4,1988-1998
185,185,Jerry Sloan,UTA,10,13,82,62,20,803,545,258,1018,639,379,0.628,20.0,13.0,7.0,117.0,63.0,54.0,123.0,65.0,58.0,1997,0.65,1988-1998
186,186,Brian Hill,MEM,1,5,82,19,63,82,19,63,377,210,167,0.557,,,,,,,36.0,18.0,18.0,1997,,1988-1998
187,187,Bernie Bickerstaff,WAS,2,9,82,42,40,117,64,53,654,325,329,0.4970000000000001,,,,3.0,0.0,3.0,33.0,12.0,21.0,1997,,1988-1998
188,188,Richie Guerin,ATL,5,5,82,48,34,372,207,165,372,207,165,0.556,11.0,5.0,6.0,40.0,19.0,21.0,40.0,19.0,21.0,1968,0.45454545454545453,1959-69
189,189,Gene Shue,WAS,3,3,82,57,25,220,109,111,220,109,111,0.495,4.0,0.0,4.0,4.0,0.0,4.0,4.0,0.0,4.0,1968,0.0,1959-69
190,190,Bill Russell,BOS,3,3,82,48,34,245,162,83,245,162,83,0.6609999999999999,18.0,12.0,6.0,46.0,28.0,18.0,46.0,28.0,18.0,1968,0.6666666666666666,1959-69
191,191,Dick Motta,CHI,1,1,82,33,49,82,33,49,82,33,49,0.402,,,,,,,,,,1968,,1959-69
194,194,Paul Seymour,DET,1,8,60,22,38,60,22,38,512,271,241,0.529,,,,,,,35.0,14.0,21.0,1968,,1959-69
195,195,Butch van Breda Kolff,LAL,2,2,82,55,27,164,107,57,164,107,57,0.652,18.0,11.0,7.0,33.0,21.0,12.0,33.0,21.0,12.0,1968,0.6111111111111112,1959-69
196,196,Larry Costello,MIL,1,1,82,27,55,82,27,55,82,27,55,0.329,,,,,,,,,,1968,,1959-69
197,197,Red Holzman,NYK,2,6,82,54,28,126,82,44,329,165,164,0.502,10.0,6.0,4.0,16.0,8.0,8.0,24.0,12.0,12.0,1968,0.6,1959-69
198,198,Jack Ramsay,PHI,1,1,82,55,27,82,55,27,82,55,27,0.6709999999999999,5.0,1.0,4.0,5.0,1.0,4.0,5.0,1.0,4.0,1968,0.2,1959-69
200,200,Jack McMahon,HOU,2,7,82,37,45,164,52,112,523,251,272,0.48,6.0,2.0,4.0,6.0,2.0,4.0,29.0,10.0,19.0,1968,0.3333333333333333,1959-69
204,204,Chris Ford,BOS,3,3,82,48,34,246,155,91,246,155,91,0.63,4.0,1.0,3.0,25.0,12.0,13.0,25.0,12.0,13.0,1992,0.25,1988-1998
206,206,Phil Jackson,CHI,4,4,82,57,25,328,240,88,328,240,88,0.732,19.0,15.0,4.0,74.0,55.0,19.0,74.0,55.0,19.0,1992,0.7894736842105263,1988-1998
207,207,Lenny Wilkens,CLE,7,20,82,54,28,574,316,258,1618,869,749,0.537,9.0,3.0,6.0,41.0,18.0,23.0,110.0,55.0,55.0,1992,0.3333333333333333,1988-1998
212,212,Don Nelson,GSW,5,16,82,34,48,410,213,197,1294,753,541,0.5820000000000001,,,,21.0,9.0,12.0,109.0,51.0,58.0,1992,,1988-1998
213,213,Rudy Tomjanovich,HOU,2,2,82,55,27,112,71,41,112,71,41,0.634,12.0,6.0,6.0,12.0,6.0,6.0,12.0,6.0,6.0,1992,0.5,1988-1998
214,214,Bob Hill,IND,3,4,82,41,41,221,113,108,287,133,154,0.463,4.0,1.0,3.0,12.0,3.0,9.0,12.0,3.0,9.0,1992,0.25,1988-1998
215,215,Larry Brown,LAC,2,14,82,41,41,117,64,53,1112,663,449,0.596,5.0,2.0,3.0,10.0,4.0,6.0,87.0,39.0,48.0,1992,0.4,1988-1998
217,217,Kevin Loughery,MIA,2,18,82,36,46,164,74,90,1260,583,677,0.463,,,,3.0,0.0,3.0,54.0,25.0,29.0,1992,,1988-1998
218,218,Mike Dunleavy,MIL,1,3,82,28,54,82,28,54,246,129,117,0.524,,,,,,,23.0,13.0,10.0,1992,,1988-1998
221,221,Chuck Daly,BRK,1,11,82,43,39,82,43,39,861,519,342,0.603,5.0,2.0,3.0,5.0,2.0,3.0,118.0,73.0,45.0,1992,0.4,1988-1998
222,222,Pat Riley,NYK,2,11,82,60,22,164,111,53,891,644,247,0.723,15.0,9.0,6.0,27.0,15.0,12.0,176.0,117.0,59.0,1992,0.6,1988-1998
224,224,Doug Moe,PHI,1,15,56,19,37,56,19,37,1157,628,529,0.5429999999999999,,,,,,,83.0,33.0,50.0,1992,,1988-1998
226,226,Paul Westphal,PHO,1,1,82,62,20,82,62,20,82,62,20,0.7559999999999999,24.0,13.0,11.0,24.0,13.0,11.0,24.0,13.0,11.0,1992,0.5416666666666666,1988-1998
227,227,Rick Adelman,POR,5,5,82,51,31,363,244,119,363,244,119,0.672,4.0,1.0,3.0,65.0,35.0,30.0,65.0,35.0,30.0,1992,0.25,1988-1998
232,232,George Karl,OKC,2,6,82,55,27,124,82,42,419,201,218,0.48,19.0,10.0,9.0,28.0,14.0,14.0,42.0,19.0,23.0,1992,0.5263157894736842,1988-1998
233,233,Jerry Sloan,UTA,5,8,82,47,35,393,251,142,608,345,263,0.5670000000000001,5.0,2.0,3.0,38.0,17.0,21.0,44.0,19.0,25.0,1992,0.4,1988-1998
237,237,Lionel Hollins,BRK,2,9,37,10,27,119,48,71,534,262,272,0.491,,,,6.0,2.0,4.0,41.0,20.0,21.0,2015,,2008-2018
243,243,Rick Carlisle,DAL,8,14,82,42,40,640,380,260,1132,661,471,0.584,5.0,1.0,4.0,58.0,28.0,30.0,120.0,58.0,62.0,2015,0.2,2008-2018
245,245,Stan Van Gundy,DET,2,10,82,44,38,164,76,88,743,447,296,0.602,4.0,0.0,4.0,4.0,0.0,4.0,91.0,48.0,43.0,2015,0.0,2008-2018
249,249,Frank Vogel,IND,6,6,82,45,37,431,250,181,431,250,181,0.58,7.0,3.0,4.0,61.0,31.0,30.0,61.0,31.0,30.0,2015,0.42857142857142855,2008-2018
250,250,Doc Rivers,LAC,3,17,82,53,29,246,166,80,1306,753,553,0.5770000000000001,6.0,2.0,4.0,33.0,15.0,18.0,154.0,79.0,75.0,2015,0.3333333333333333,2008-2018
251,251,Byron Scott,LAL,2,15,82,17,65,164,38,126,1101,454,647,0.412,,,,,,,57.0,33.0,24.0,2015,,2008-2018
253,253,Erik Spoelstra,MIA,8,8,82,48,34,640,399,241,640,399,241,0.623,14.0,7.0,7.0,113.0,70.0,43.0,113.0,70.0,43.0,2015,0.5,2008-2018
256,256,Alvin Gentry,NOP,1,13,82,30,52,82,30,52,787,365,422,0.464,,,,,,,21.0,12.0,9.0,2015,,2008-2018
260,260,Scott Skiles,ORL,1,14,82,35,47,82,35,47,958,478,480,0.499,,,,,,,42.0,18.0,24.0,2015,,2008-2018
264,264,Terry Stotts,POR,4,8,82,44,38,328,182,146,611,297,314,0.486,11.0,5.0,6.0,27.0,11.0,16.0,32.0,12.0,20.0,2015,0.45454545454545453,2008-2018
265,265,George Karl,SAC,2,27,82,33,49,112,44,68,1999,1175,824,0.588,,,,,,,185.0,80.0,105.0,2015,,2008-2018
266,266,Gregg Popovich,SAS,20,20,82,67,15,1574,1089,485,1574,1089,485,0.6920000000000001,10.0,6.0,4.0,256.0,158.0,98.0,256.0,158.0,98.0,2015,0.6,2008-2018
267,267,Dwane Casey,TOR,5,7,82,56,26,394,210,184,516,263,253,0.51,20.0,10.0,10.0,31.0,13.0,18.0,31.0,13.0,18.0,2015,0.5,2008-2018
269,269,Randy Wittman,WAS,5,10,82,41,41,377,178,199,684,278,406,0.406,,,,21.0,12.0,9.0,21.0,12.0,9.0,2015,,2008-2018
270,270,Red Auerbach,BOS,12,16,80,60,20,872,562,310,1097,705,392,0.643,14.0,8.0,6.0,96.0,55.0,41.0,116.0,64.0,52.0,1961,0.5714285714285714,1959-69
277,277,Paul Seymour,ATL,2,6,14,5,9,93,56,37,372,211,161,0.5670000000000001,,,,12.0,5.0,7.0,32.0,14.0,18.0,1961,,1959-69
280,280,Alex Hannum,PHI,2,4,80,41,39,159,79,80,262,135,127,0.515,5.0,2.0,3.0,13.0,6.0,7.0,34.0,20.0,14.0,1961,0.4,1959-69
287,287,Rick Carlisle,DAL,9,15,82,33,49,722,413,309,1214,694,520,0.5720000000000001,,,,58.0,28.0,30.0,120.0,58.0,62.0,2016,,2008-2018
289,289,Stan Van Gundy,DET,3,11,82,37,45,246,113,133,825,484,341,0.5870000000000001,,,,4.0,0.0,4.0,91.0,48.0,43.0,2016,,2008-2018
291,291,Mike D'Antoni,HOU,1,13,82,55,27,82,55,27,963,510,453,0.53,11.0,6.0,5.0,11.0,6.0,5.0,70.0,32.0,38.0,2016,0.5454545454545454,2008-2018
292,292,Nate McMillan,IND,1,13,82,42,40,82,42,40,1012,520,492,0.514,4.0,0.0,4.0,4.0,0.0,4.0,38.0,14.0,24.0,2016,0.0,2008-2018
293,293,Doc Rivers,LAC,4,18,82,51,31,328,217,111,1388,804,584,0.579,7.0,3.0,4.0,40.0,18.0,22.0,161.0,82.0,79.0,2016,0.42857142857142855,2008-2018
296,296,Erik Spoelstra,MIA,9,9,82,41,41,722,440,282,722,440,282,0.609,,,,113.0,70.0,43.0,113.0,70.0,43.0,2016,,2008-2018
298,298,Tom Thibodeau,MIN,1,6,82,31,51,82,31,51,476,286,190,0.601,,,,,,,51.0,23.0,28.0,2016,,2008-2018
299,299,Alvin Gentry,NOP,2,14,82,34,48,164,64,100,869,399,470,0.459,,,,,,,21.0,12.0,9.0,2016,,2008-2018
302,302,Frank Vogel,ORL,1,7,82,29,53,82,29,53,513,279,234,0.544,,,,,,,61.0,31.0,30.0,2016,,2008-2018
305,305,Terry Stotts,POR,5,9,82,41,41,410,223,187,693,338,355,0.488,4.0,0.0,4.0,31.0,11.0,20.0,36.0,12.0,24.0,2016,0.0,2008-2018
307,307,Gregg Popovich,SAS,21,21,82,61,21,1656,1150,506,1656,1150,506,0.6940000000000001,16.0,8.0,8.0,272.0,166.0,106.0,272.0,166.0,106.0,2016,0.5,2008-2018
308,308,Dwane Casey,TOR,6,8,82,51,31,476,261,215,598,314,284,0.525,10.0,4.0,6.0,41.0,17.0,24.0,41.0,17.0,24.0,2016,0.4,2008-2018
310,310,Scott Brooks,WAS,1,8,82,49,33,82,49,33,627,387,240,0.617,13.0,7.0,6.0,13.0,7.0,6.0,86.0,46.0,40.0,2016,0.5384615384615384,2008-2018
311,311,Red Auerbach,BOS,8,12,72,49,23,566,334,232,791,477,314,0.603,11.0,6.0,5.0,48.0,23.0,25.0,68.0,32.0,36.0,1957,0.5454545454545454,1950-59
316,316,John Kundla,LAL,10,10,33,10,23,653,390,263,653,390,263,0.597,,,,82.0,54.0,28.0,82.0,54.0,28.0,1957,,1950-59
319,319,Alex Hannum,ATL,2,2,72,41,31,103,56,47,103,56,47,0.544,11.0,8.0,3.0,21.0,14.0,7.0,21.0,14.0,7.0,1957,0.7272727272727273,1950-59
320,320,Paul Seymour,PHI,2,2,72,41,31,132,75,57,132,75,57,0.568,3.0,1.0,2.0,8.0,3.0,5.0,8.0,3.0,5.0,1957,0.3333333333333333,1950-59
321,321,Mike Fratello,ATL,8,8,82,41,41,577,324,253,577,324,253,0.562,,,,40.0,18.0,22.0,40.0,18.0,22.0,1989,,1988-1998
325,325,Phil Jackson,CHI,1,1,82,55,27,82,55,27,82,55,27,0.6709999999999999,16.0,10.0,6.0,16.0,10.0,6.0,16.0,10.0,6.0,1989,0.625,1988-1998
326,326,Lenny Wilkens,CLE,4,17,82,42,40,328,172,156,1372,725,647,0.528,5.0,2.0,3.0,15.0,6.0,9.0,84.0,43.0,41.0,1989,0.4,1988-1998
327,327,John MacLeod,DAL,3,17,11,5,6,175,96,79,1297,675,622,0.52,,,,17.0,10.0,7.0,98.0,47.0,51.0,1989,,1988-1998
329,329,Doug Moe,DEN,10,14,82,43,39,789,432,357,1101,609,492,0.5529999999999999,3.0,0.0,3.0,61.0,24.0,37.0,83.0,33.0,50.0,1989,0.0,1988-1998
330,330,Chuck Daly,DET,7,8,82,59,23,574,369,205,615,378,237,0.615,20.0,15.0,5.0,93.0,62.0,31.0,93.0,62.0,31.0,1989,0.75,1988-1998
331,331,Don Nelson,GSW,2,13,82,37,45,164,80,84,1048,620,428,0.5920000000000001,,,,8.0,4.0,4.0,96.0,46.0,50.0,1989,,1988-1998
332,332,Don Chaney,HOU,2,5,82,41,41,164,86,78,349,139,210,0.398,4.0,1.0,3.0,8.0,2.0,6.0,8.0,2.0,6.0,1989,0.25,1988-1998
335,335,Pat Riley,LAL,9,9,82,63,19,727,533,194,727,533,194,0.733,9.0,4.0,5.0,149.0,102.0,47.0,149.0,102.0,47.0,1989,0.4444444444444444,1988-1998
337,337,Del Harris,MIL,3,7,82,44,38,246,135,111,574,276,298,0.481,4.0,1.0,3.0,18.0,6.0,12.0,49.0,21.0,28.0,1989,0.25,1988-1998
339,339,Bill Fitch,BRK,1,19,82,17,65,82,17,65,1558,779,779,0.5,,,,,,,102.0,54.0,48.0,1989,,1988-1998
342,342,Jim Lynam,PHI,3,5,82,53,29,203,115,88,346,167,179,0.483,10.0,4.0,6.0,13.0,4.0,9.0,13.0,4.0,9.0,1989,0.4,1988-1998
343,343,Cotton Fitzsimmons,PHO,4,17,82,54,28,328,206,122,1386,697,689,0.503,16.0,9.0,7.0,28.0,16.0,12.0,68.0,29.0,39.0,1989,0.5625,1988-1998
344,344,Rick Adelman,POR,2,2,82,59,23,117,73,44,117,73,44,0.624,21.0,12.0,9.0,24.0,12.0,12.0,24.0,12.0,12.0,1989,0.5714285714285714,1988-1998
346,346,Dick Motta,SAC,1,20,54,16,38,54,16,38,1612,824,788,0.511,,,,,,,126.0,56.0,70.0,1989,,1988-1998
347,347,Larry Brown,SAS,2,11,82,56,26,164,77,87,875,523,352,0.598,10.0,6.0,4.0,10.0,6.0,4.0,73.0,34.0,39.0,1989,0.6,1988-1998
348,348,Bernie Bickerstaff,OKC,5,5,82,41,41,410,202,208,410,202,208,0.493,,,,27.0,12.0,15.0,27.0,12.0,15.0,1989,,1988-1998
349,349,Jerry Sloan,UTA,2,5,82,55,27,147,95,52,362,189,173,0.522,5.0,2.0,3.0,8.0,2.0,6.0,14.0,4.0,10.0,1989,0.4,1988-1998
351,351,Mike Fratello,ATL,5,5,82,57,25,331,181,150,331,181,150,0.547,9.0,4.0,5.0,23.0,10.0,13.0,23.0,10.0,13.0,1986,0.4444444444444444,1979-1988
352,352,K.C. Jones,BOS,4,8,82,59,23,328,251,77,658,436,222,0.6629999999999999,23.0,13.0,10.0,85.0,56.0,29.0,120.0,70.0,50.0,1986,0.5652173913043478,1979-1988
353,353,Doug Collins,CHI,1,1,82,40,42,82,40,42,82,40,42,0.488,3.0,0.0,3.0,3.0,0.0,3.0,3.0,0.0,3.0,1986,0.0,1979-1988
354,354,Lenny Wilkens,CLE,1,14,82,31,51,82,31,51,1126,584,542,0.519,,,,,,,69.0,37.0,32.0,1986,,1979-1988
355,355,Dick Motta,DAL,7,19,82,55,27,574,267,307,1558,808,750,0.519,4.0,1.0,3.0,28.0,11.0,17.0,126.0,56.0,70.0,1986,0.25,1979-1988
356,356,Doug Moe,DEN,7,11,82,37,45,543,291,252,855,468,387,0.547,3.0,0.0,3.0,44.0,19.0,25.0,66.0,28.0,38.0,1986,0.0,1979-1988
357,357,Chuck Daly,DET,4,5,82,52,30,328,193,135,369,202,167,0.547,15.0,10.0,5.0,33.0,18.0,15.0,33.0,18.0,15.0,1986,0.6666666666666666,1979-1988
358,358,George Karl,GSW,1,3,82,42,40,82,42,40,231,103,128,0.446,10.0,4.0,6.0,10.0,4.0,6.0,14.0,5.0,9.0,1986,0.4,1979-1988
359,359,Bill Fitch,HOU,4,17,82,42,40,328,170,158,1394,716,678,0.514,10.0,5.0,5.0,35.0,20.0,15.0,98.0,53.0,45.0,1986,0.5,1979-1988
360,360,Jack Ramsay,IND,1,19,82,41,41,82,41,41,1558,826,732,0.53,4.0,1.0,3.0,4.0,1.0,3.0,102.0,44.0,58.0,1986,0.25,1979-1988
361,361,Don Chaney,LAC,3,3,82,12,70,185,53,132,185,53,132,0.28600000000000003,,,,,,,,,,1986,,1979-1988
362,362,Pat Riley,LAL,6,6,82,65,17,481,351,130,481,351,130,0.73,18.0,15.0,3.0,101.0,72.0,29.0,101.0,72.0,29.0,1986,0.8333333333333334,1979-1988
363,363,Don Nelson,MIL,11,11,82,50,32,884,540,344,884,540,344,0.611,12.0,6.0,6.0,88.0,42.0,46.0,88.0,42.0,46.0,1986,0.5,1979-1988
365,365,Hubie Brown,NYK,5,12,16,4,12,344,142,202,919,445,474,0.484,,,,18.0,8.0,10.0,59.0,31.0,28.0,1986,,1979-1988
366,366,Bob Hill,NYK,1,1,66,20,46,66,20,46,66,20,46,0.303,,,,,,,,,,1986,,1979-1988
368,368,John MacLeod,PHO,14,14,56,22,34,1122,579,543,1122,579,543,0.516,,,,81.0,37.0,44.0,81.0,37.0,44.0,1986,,1979-1988
371,371,Phil Johnson,SAC,8,9,46,14,32,542,236,306,543,236,307,0.435,,,,9.0,2.0,7.0,9.0,2.0,7.0,1986,,1979-1988
374,374,Bernie Bickerstaff,OKC,2,2,82,39,43,164,70,94,164,70,94,0.4270000000000001,14.0,7.0,7.0,14.0,7.0,7.0,14.0,7.0,7.0,1986,0.5,1979-1988
375,375,Frank Layden,UTA,6,6,82,44,38,472,219,253,472,219,253,0.464,5.0,2.0,3.0,30.0,12.0,18.0,30.0,12.0,18.0,1986,0.4,1979-1988
376,376,Kevin Loughery,WAS,2,15,82,42,40,95,49,46,1069,501,568,0.469,3.0,0.0,3.0,8.0,2.0,6.0,51.0,25.0,26.0,1986,0.0,1979-1988
377,377,Lenny Wilkens,ATL,7,27,82,28,54,542,310,232,2160,1179,981,0.546,,,,47.0,17.0,30.0,157.0,72.0,85.0,1999,,1998-2008
379,379,Paul Silas,NOP,2,5,82,49,33,117,71,46,363,149,214,0.41,4.0,1.0,3.0,4.0,1.0,3.0,4.0,1.0,3.0,1999,0.25,1998-2008
381,381,Randy Wittman,CLE,1,1,82,32,50,82,32,50,82,32,50,0.39,,,,,,,,,,1999,,1998-2008
382,382,Don Nelson,DAL,3,22,82,40,42,198,75,123,1678,926,752,0.552,,,,,,,112.0,51.0,61.0,1999,,1998-2008
384,384,Alvin Gentry,DET,3,4,58,28,30,145,73,72,181,88,93,0.486,,,,5.0,2.0,3.0,5.0,2.0,3.0,1999,,1998-2008
386,386,P.J. Carlesimo,GSW,3,6,27,6,21,159,46,113,405,183,222,0.452,,,,,,,12.0,3.0,9.0,1999,,1998-2008
388,388,Rudy Tomjanovich,HOU,9,9,82,34,48,654,387,267,654,387,267,0.5920000000000001,,,,90.0,51.0,39.0,90.0,51.0,39.0,1999,,1998-2008
390,390,Chris Ford,LAC,2,9,45,11,34,95,20,75,669,311,358,0.465,,,,,,,29.0,13.0,16.0,1999,,1998-2008
392,392,Phil Jackson,LAL,1,10,82,67,15,82,67,15,820,612,208,0.746,23.0,15.0,8.0,23.0,15.0,8.0,175.0,126.0,49.0,1999,0.6521739130434783,1998-2008
393,393,Pat Riley,MIA,5,18,82,52,30,378,243,135,1433,999,434,0.6970000000000001,10.0,6.0,4.0,40.0,18.0,22.0,252.0,155.0,97.0,1999,0.6,1998-2008
394,394,George Karl,MIL,2,13,82,42,40,132,70,62,961,573,388,0.596,5.0,2.0,3.0,8.0,2.0,6.0,102.0,47.0,55.0,1999,0.4,1998-2008
395,395,Flip Saunders,MIN,5,5,82,50,32,358,180,178,358,180,178,0.503,4.0,1.0,3.0,16.0,4.0,12.0,16.0,4.0,12.0,1999,0.25,1998-2008
397,397,Jeff Van Gundy,NYK,5,5,82,50,32,319,190,129,319,190,129,0.596,16.0,9.0,7.0,64.0,35.0,29.0,64.0,35.0,29.0,1999,0.5625,1998-2008
398,398,Doc Rivers,ORL,1,1,82,41,41,82,41,41,82,41,41,0.5,,,,,,,,,,1999,,1998-2008
399,399,Larry Brown,PHI,3,21,82,49,33,214,108,106,1654,961,693,0.581,10.0,5.0,5.0,18.0,8.0,10.0,143.0,69.0,74.0,1999,0.5,1998-2008
401,401,Scott Skiles,PHO,1,1,62,40,22,62,40,22,62,40,22,0.645,9.0,4.0,5.0,9.0,4.0,5.0,9.0,4.0,5.0,1999,0.4444444444444444,1998-2008
402,402,Mike Dunleavy,POR,3,9,82,59,23,214,140,74,706,348,358,0.493,16.0,10.0,6.0,33.0,18.0,15.0,56.0,31.0,25.0,1999,0.625,1998-2008
403,403,Rick Adelman,SAC,2,10,82,44,38,132,71,61,741,428,313,0.578,5.0,2.0,3.0,10.0,4.0,6.0,79.0,40.0,39.0,1999,0.4,1998-2008
404,404,Gregg Popovich,SAS,4,4,82,53,29,278,163,115,278,163,115,0.586,4.0,1.0,3.0,30.0,20.0,10.0,30.0,20.0,10.0,1999,0.25,1998-2008
405,405,Paul Westphal,OKC,2,6,82,45,37,132,70,62,411,261,150,0.635,5.0,2.0,3.0,5.0,2.0,3.0,49.0,27.0,22.0,1999,0.4,1998-2008
407,407,Jerry Sloan,UTA,12,15,82,55,27,935,637,298,1150,731,419,0.636,10.0,4.0,6.0,138.0,72.0,66.0,144.0,74.0,70.0,1999,0.4,1998-2008
408,408,Brian Hill,MEM,3,7,22,4,18,154,31,123,449,222,227,0.494,,,,,,,36.0,18.0,18.0,1999,,1998-2008
409,409,Lionel Hollins,MEM,1,1,60,18,42,60,18,42,60,18,42,0.3,,,,,,,,,,1999,,1998-2008
414,414,Red Auerbach,BOS,2,6,66,39,27,135,78,57,360,221,139,0.614,3.0,1.0,2.0,5.0,1.0,4.0,25.0,10.0,15.0,1951,0.3333333333333333,1950-59
418,418,John Kundla,LAL,4,4,66,40,26,262,179,83,262,179,83,0.6829999999999999,13.0,9.0,4.0,42.0,30.0,12.0,42.0,30.0,12.0,1951,0.6923076923076923,1950-59
422,422,Al Cervi,PHI,3,3,66,40,26,196,123,73,196,123,73,0.628,7.0,3.0,4.0,25.0,13.0,12.0,25.0,13.0,12.0,1951,0.42857142857142855,1950-59
423,423,Mike Woodson,ATL,6,6,82,53,29,492,206,286,492,206,286,0.419,11.0,4.0,7.0,29.0,11.0,18.0,29.0,11.0,18.0,2009,0.36363636363636365,2008-2018
424,424,Doc Rivers,BOS,6,11,82,50,32,492,280,212,831,451,380,0.5429999999999999,24.0,15.0,9.0,71.0,41.0,30.0,86.0,46.0,40.0,2009,0.625,2008-2018
425,425,Larry Brown,CHO,2,29,82,44,38,164,79,85,2310,1318,992,0.5710000000000001,4.0,0.0,4.0,4.0,0.0,4.0,235.0,120.0,115.0,2009,0.0,2008-2018
427,427,Mike Brown,CLE,5,5,82,61,21,410,272,138,410,272,138,0.6629999999999999,11.0,6.0,5.0,71.0,42.0,29.0,71.0,42.0,29.0,2009,0.5454545454545454,2008-2018
428,428,Rick Carlisle,DAL,2,8,82,55,27,164,105,59,656,386,270,0.588,6.0,2.0,4.0,16.0,7.0,9.0,78.0,37.0,41.0,2009,0.3333333333333333,2008-2018
429,429,George Karl,DEN,6,22,82,53,29,450,278,172,1657,986,671,0.595,6.0,2.0,4.0,41.0,15.0,26.0,167.0,74.0,93.0,2009,0.3333333333333333,2008-2018
431,431,Don Nelson,GSW,11,31,82,26,56,865,422,443,2398,1335,1063,0.557,,,,35.0,14.0,21.0,166.0,75.0,91.0,2009,,2008-2018
432,432,Rick Adelman,HOU,3,19,82,42,40,246,150,96,1479,902,577,0.61,,,,19.0,9.0,10.0,157.0,79.0,78.0,2009,,2008-2018
433,433,Jim O'Brien,IND,3,8,82,32,50,246,104,142,586,286,300,0.488,,,,,,,31.0,14.0,17.0,2009,,2008-2018
434,434,Mike Dunleavy,LAC,7,17,49,21,28,541,215,326,1329,613,716,0.461,,,,12.0,7.0,5.0,71.0,38.0,33.0,2009,,2008-2018
436,436,Phil Jackson,LAL,10,19,82,57,25,820,553,267,1558,1098,460,0.705,23.0,16.0,7.0,171.0,114.0,57.0,323.0,225.0,98.0,2009,0.6956521739130435,2008-2018
437,437,Lionel Hollins,MEM,4,4,82,40,42,185,71,114,185,71,114,0.384,,,,,,,,,,2009,,2008-2018
438,438,Erik Spoelstra,MIA,2,2,82,47,35,164,90,74,164,90,74,0.5489999999999999,5.0,1.0,4.0,12.0,4.0,8.0,12.0,4.0,8.0,2009,0.2,2008-2018
439,439,Scott Skiles,MIL,2,10,82,46,36,164,80,84,696,361,335,0.519,7.0,3.0,4.0,7.0,3.0,4.0,42.0,18.0,24.0,2009,0.42857142857142855,2008-2018
441,441,Lawrence Frank,BRK,7,7,16,0,16,466,225,241,466,225,241,0.483,,,,38.0,18.0,20.0,38.0,18.0,20.0,2009,,2008-2018
444,444,Byron Scott,NOP,6,10,9,3,6,419,203,216,707,352,355,0.498,,,,17.0,8.0,9.0,57.0,33.0,24.0,2009,,2008-2018
446,446,Mike D'Antoni,NYK,2,8,82,29,53,164,61,103,603,328,275,0.544,,,,,,,51.0,26.0,25.0,2009,,2008-2018
447,447,Scott Brooks,OKC,2,2,82,50,32,151,72,79,151,72,79,0.477,6.0,2.0,4.0,6.0,2.0,4.0,6.0,2.0,4.0,2009,0.3333333333333333,2008-2018
448,448,Stan Van Gundy,ORL,3,6,82,59,23,246,170,76,431,282,149,0.654,14.0,10.0,4.0,48.0,28.0,20.0,76.0,45.0,31.0,2009,0.7142857142857143,2008-2018
449,449,Eddie Jordan,PHI,1,9,82,27,55,82,27,55,600,257,343,0.428,,,,,,,26.0,8.0,18.0,2009,,2008-2018
450,450,Alvin Gentry,PHO,2,9,82,54,28,113,72,41,516,249,267,0.483,16.0,10.0,6.0,16.0,10.0,6.0,21.0,12.0,9.0,2009,0.625,2008-2018
451,451,Nate McMillan,POR,5,10,82,50,32,410,198,212,805,410,395,0.509,6.0,2.0,4.0,12.0,4.0,8.0,28.0,12.0,16.0,2009,0.3333333333333333,2008-2018
452,452,Paul Westphal,SAC,1,8,82,25,57,82,25,57,508,292,216,0.575,,,,,,,49.0,27.0,22.0,2009,,2008-2018
453,453,Gregg Popovich,SAS,14,14,82,50,32,1098,736,362,1098,736,362,0.67,10.0,4.0,6.0,175.0,106.0,69.0,175.0,106.0,69.0,2009,0.4,2008-2018
455,455,Jerry Sloan,UTA,22,25,82,53,29,1755,1096,659,1970,1190,780,0.604,10.0,4.0,6.0,196.0,96.0,100.0,202.0,98.0,104.0,2009,0.4,2008-2018
456,456,Flip Saunders,WAS,1,14,82,26,56,82,26,56,1065,613,452,0.5760000000000001,,,,,,,98.0,47.0,51.0,2009,,2008-2018
457,457,Hubie Brown,ATL,3,5,82,46,36,246,118,128,414,222,192,0.536,9.0,5.0,4.0,11.0,5.0,6.0,36.0,22.0,14.0,1978,0.5555555555555556,1969-1979
460,460,Larry Costello,CHI,1,10,56,20,36,56,20,36,730,430,300,0.589,,,,,,,60.0,37.0,23.0,1978,,1969-1979
462,462,Bill Fitch,CLE,9,9,82,30,52,738,304,434,738,304,434,0.412,,,,18.0,7.0,11.0,18.0,7.0,11.0,1978,,1969-1979
463,463,Larry Brown,DEN,5,7,53,28,25,385,251,134,553,355,198,0.642,,,,45.0,21.0,24.0,61.0,28.0,33.0,1978,,1969-1979
466,466,Al Attles,GSW,10,10,82,38,44,768,425,343,768,425,343,0.5529999999999999,,,,61.0,31.0,30.0,61.0,31.0,30.0,1978,,1969-1979
467,467,Tom Nissalke,HOU,3,8,82,47,35,246,124,122,531,260,271,0.49,2.0,0.0,2.0,14.0,6.0,8.0,31.0,11.0,20.0,1978,0.0,1969-1979
469,469,Cotton Fitzsimmons,SAC,1,8,82,48,34,82,48,34,648,312,336,0.481,5.0,1.0,4.0,5.0,1.0,4.0,11.0,3.0,8.0,1978,0.2,1969-1979
471,471,Don Nelson,MIL,3,3,82,38,44,228,109,119,228,109,119,0.478,,,,9.0,5.0,4.0,9.0,5.0,4.0,1978,,1969-1979
472,472,Kevin Loughery,BRK,6,7,82,37,45,498,251,247,529,256,273,0.484,2.0,0.0,2.0,34.0,21.0,13.0,34.0,21.0,13.0,1978,0.0,1969-1979
475,475,Red Holzman,NYK,11,15,68,25,43,850,491,359,1053,574,479,0.545,,,,95.0,54.0,41.0,103.0,58.0,45.0,1978,,1969-1979
476,476,Billy Cunningham,PHI,2,2,82,47,35,158,100,58,158,100,58,0.633,9.0,5.0,4.0,19.0,11.0,8.0,19.0,11.0,8.0,1978,0.5555555555555556,1969-1979
477,477,John MacLeod,PHO,6,6,82,50,32,492,237,255,492,237,255,0.482,15.0,9.0,6.0,36.0,19.0,17.0,36.0,19.0,17.0,1978,0.6,1969-1979
478,478,Jack Ramsay,POR,3,11,82,45,37,246,152,94,902,484,418,0.537,3.0,1.0,2.0,28.0,17.0,11.0,67.0,31.0,36.0,1978,0.3333333333333333,1969-1979
479,479,Doug Moe,SAS,3,3,82,48,34,246,144,102,246,144,102,0.585,14.0,7.0,7.0,22.0,9.0,13.0,22.0,9.0,13.0,1978,0.5,1969-1979
480,480,Gene Shue,LAC,1,13,82,43,39,82,43,39,964,491,473,0.509,,,,,,,62.0,25.0,37.0,1978,,1969-1979
481,481,Lenny Wilkens,OKC,5,7,82,52,30,388,215,173,552,290,262,0.525,17.0,12.0,5.0,39.0,25.0,14.0,39.0,25.0,14.0,1978,0.7058823529411765,1969-1979
482,482,Dick Motta,WAS,3,11,82,54,28,246,146,100,902,502,400,0.557,19.0,9.0,10.0,49.0,27.0,22.0,96.0,45.0,51.0,1978,0.47368421052631576,1969-1979
483,483,Mike Fratello,ATL,3,3,82,34,48,167,74,93,167,74,93,0.443,,,,5.0,2.0,3.0,5.0,2.0,3.0,1984,,1979-1988
484,484,K.C. Jones,BOS,2,6,82,63,19,164,125,39,494,310,184,0.628,21.0,13.0,8.0,44.0,28.0,16.0,79.0,42.0,37.0,1984,0.6190476190476191,1979-1988
485,485,Kevin Loughery,CHI,2,13,82,38,44,164,65,99,974,452,522,0.464,4.0,1.0,3.0,4.0,1.0,3.0,43.0,23.0,20.0,1984,0.25,1979-1988
486,486,George Karl,CLE,1,1,82,36,46,82,36,46,82,36,46,0.439,4.0,1.0,3.0,4.0,1.0,3.0,4.0,1.0,3.0,1984,0.25,1979-1988
487,487,Dick Motta,DAL,5,17,82,44,38,410,168,242,1394,709,685,0.509,4.0,1.0,3.0,14.0,5.0,9.0,112.0,50.0,62.0,1984,0.25,1979-1988
488,488,Doug Moe,DEN,5,9,82,52,30,379,207,172,691,384,307,0.556,15.0,8.0,7.0,31.0,14.0,17.0,53.0,23.0,30.0,1984,0.5333333333333333,1979-1988
489,489,Chuck Daly,DET,2,3,82,46,36,164,95,69,205,104,101,0.507,9.0,5.0,4.0,14.0,7.0,7.0,14.0,7.0,7.0,1984,0.5555555555555556,1979-1988
491,491,Bill Fitch,HOU,2,15,82,48,34,164,77,87,1230,623,607,0.507,5.0,2.0,3.0,5.0,2.0,3.0,68.0,35.0,33.0,1984,0.4,1979-1988
494,494,Phil Johnson,SAC,6,7,73,30,43,414,185,229,415,185,230,0.446,,,,6.0,2.0,4.0,6.0,2.0,4.0,1984,,1979-1988
495,495,Jim Lynam,LAC,2,2,61,22,39,143,52,91,143,52,91,0.364,,,,,,,,,,1984,,1979-1988
496,496,Don Chaney,LAC,1,1,21,9,12,21,9,12,21,9,12,0.429,,,,,,,,,,1984,,1979-1988
497,497,Pat Riley,LAL,4,4,82,62,20,317,224,93,317,224,93,0.7070000000000001,19.0,15.0,4.0,69.0,49.0,20.0,69.0,49.0,20.0,1984,0.7894736842105263,1979-1988
498,498,Don Nelson,MIL,9,9,82,59,23,720,433,287,720,433,287,0.601,8.0,3.0,5.0,62.0,29.0,33.0,62.0,29.0,33.0,1984,0.375,1979-1988
500,500,Hubie Brown,NYK,3,10,82,24,58,246,115,131,821,418,403,0.509,,,,18.0,8.0,10.0,59.0,31.0,28.0,1984,,1979-1988
501,501,Billy Cunningham,PHI,8,8,82,58,24,650,454,196,650,454,196,0.698,13.0,8.0,5.0,105.0,66.0,39.0,105.0,66.0,39.0,1984,0.6153846153846154,1979-1988
502,502,John MacLeod,PHO,12,12,82,36,46,984,525,459,984,525,459,0.534,3.0,0.0,3.0,81.0,37.0,44.0,81.0,37.0,44.0,1984,0.0,1979-1988
503,503,Jack Ramsay,POR,9,17,82,42,40,738,413,325,1394,745,649,0.534,9.0,4.0,5.0,55.0,28.0,27.0,94.0,42.0,52.0,1984,0.4444444444444444,1979-1988
504,504,Cotton Fitzsimmons,SAS,1,14,82,41,41,82,41,41,1140,553,587,0.485,5.0,2.0,3.0,5.0,2.0,3.0,37.0,13.0,24.0,1984,0.4,1979-1988
505,505,Lenny Wilkens,OKC,11,13,82,31,51,880,478,402,1044,553,491,0.53,,,,69.0,37.0,32.0,69.0,37.0,32.0,1984,,1979-1988
506,506,Frank Layden,UTA,4,4,82,41,41,308,133,175,308,133,175,0.4320000000000001,10.0,4.0,6.0,21.0,9.0,12.0,21.0,9.0,12.0,1984,0.4,1979-1988
507,507,Gene Shue,WAS,12,19,82,40,42,958,490,468,1456,725,731,0.498,4.0,1.0,3.0,55.0,19.0,36.0,77.0,30.0,47.0,1984,0.25,1979-1988
510,510,Lionel Hollins,BRK,1,8,82,38,44,82,38,44,497,252,245,0.507,6.0,2.0,4.0,6.0,2.0,4.0,41.0,20.0,21.0,2014,0.3333333333333333,2008-2018
511,511,Tom Thibodeau,CHI,5,5,82,50,32,394,255,139,394,255,139,0.647,12.0,6.0,6.0,51.0,23.0,28.0,51.0,23.0,28.0,2014,0.5,2008-2018
514,514,Rick Carlisle,DAL,7,13,82,50,32,558,338,220,1050,619,431,0.59,5.0,1.0,4.0,53.0,27.0,26.0,115.0,57.0,58.0,2014,0.2,2008-2018
517,517,Stan Van Gundy,DET,1,9,82,32,50,82,32,50,661,403,258,0.61,,,,,,,87.0,48.0,39.0,2014,,2008-2018
520,520,Frank Vogel,IND,5,5,82,38,44,349,205,144,349,205,144,0.5870000000000001,,,,54.0,28.0,26.0,54.0,28.0,26.0,2014,,2008-2018
521,521,Doc Rivers,LAC,2,16,82,56,26,164,113,51,1224,700,524,0.5720000000000001,14.0,7.0,7.0,27.0,13.0,14.0,148.0,77.0,71.0,2014,0.5,2008-2018
522,522,Byron Scott,LAL,1,14,82,21,61,82,21,61,1019,437,582,0.429,,,,,,,57.0,33.0,24.0,2014,,2008-2018
524,524,Erik Spoelstra,MIA,7,7,82,37,45,558,351,207,558,351,207,0.629,,,,99.0,63.0,36.0,99.0,63.0,36.0,2014,,2008-2018
526,526,Flip Saunders,MIN,11,17,82,16,66,819,427,392,1246,654,592,0.525,,,,47.0,17.0,30.0,98.0,47.0,51.0,2014,,2008-2018
529,529,Scott Brooks,OKC,7,7,82,45,37,545,338,207,545,338,207,0.62,,,,73.0,39.0,34.0,73.0,39.0,34.0,2014,,2008-2018
534,534,Terry Stotts,POR,3,7,82,51,31,246,138,108,529,253,276,0.478,5.0,1.0,4.0,16.0,6.0,10.0,21.0,7.0,14.0,2014,0.2,2008-2018
537,537,George Karl,SAC,1,26,30,11,19,30,11,19,1917,1142,775,0.596,,,,,,,185.0,80.0,105.0,2014,,2008-2018
538,538,Gregg Popovich,SAS,19,19,82,55,27,1492,1022,470,1492,1022,470,0.685,7.0,3.0,4.0,246.0,152.0,94.0,246.0,152.0,94.0,2014,0.42857142857142855,2008-2018
539,539,Dwane Casey,TOR,4,6,82,49,33,312,154,158,434,207,227,0.477,4.0,0.0,4.0,11.0,3.0,8.0,11.0,3.0,8.0,2014,0.0,2008-2018
541,541,Randy Wittman,WAS,4,9,82,46,36,295,137,158,602,237,365,0.394,10.0,6.0,4.0,21.0,12.0,9.0,21.0,12.0,9.0,2014,0.6,2008-2018
542,542,Mike Woodson,ATL,2,2,82,26,56,164,39,125,164,39,125,0.238,,,,,,,,,,2005,,1998-2008
543,543,Doc Rivers,BOS,2,7,82,33,49,164,78,86,503,249,254,0.495,,,,7.0,3.0,4.0,22.0,8.0,14.0,2005,,1998-2008
544,544,Bernie Bickerstaff,CHO,2,12,82,26,56,164,44,120,850,382,468,0.449,,,,,,,33.0,12.0,21.0,2005,,1998-2008
545,545,Scott Skiles,CHI,3,6,82,41,41,230,107,123,425,223,202,0.525,6.0,2.0,4.0,12.0,4.0,8.0,25.0,9.0,16.0,2005,0.3333333333333333,1998-2008
546,546,Mike Brown,CLE,1,1,82,50,32,82,50,32,82,50,32,0.61,13.0,7.0,6.0,13.0,7.0,6.0,13.0,7.0,6.0,2005,0.5384615384615384,1998-2008
548,548,George Karl,DEN,2,18,82,44,38,122,76,46,1329,784,545,0.59,5.0,1.0,4.0,10.0,2.0,8.0,136.0,61.0,75.0,2005,0.2,1998-2008
549,549,Flip Saunders,DET,1,11,82,64,18,82,64,18,819,475,344,0.58,18.0,10.0,8.0,18.0,10.0,8.0,65.0,27.0,38.0,2005,0.5555555555555556,1998-2008
551,551,Jeff Van Gundy,HOU,3,10,82,34,48,246,130,116,666,378,288,0.568,,,,12.0,4.0,8.0,81.0,41.0,40.0,2005,,1998-2008
552,552,Rick Carlisle,IND,3,5,82,41,41,246,146,100,410,246,164,0.6,6.0,2.0,4.0,35.0,18.0,17.0,62.0,30.0,32.0,2005,0.3333333333333333,1998-2008
553,553,Mike Dunleavy,LAC,3,13,82,47,35,246,112,134,1034,510,524,0.493,12.0,7.0,5.0,12.0,7.0,5.0,71.0,38.0,33.0,2005,0.5833333333333334,1998-2008
554,554,Phil Jackson,LAL,6,15,82,45,37,492,332,160,1230,877,353,0.713,7.0,3.0,4.0,99.0,67.0,32.0,251.0,178.0,73.0,2005,0.42857142857142855,1998-2008
555,555,Mike Fratello,MEM,2,16,82,49,33,148,89,59,1185,661,524,0.5579999999999999,4.0,0.0,4.0,8.0,0.0,8.0,62.0,20.0,42.0,2005,0.0,1998-2008
556,556,Stan Van Gundy,MIA,3,3,21,11,10,185,112,73,185,112,73,0.605,,,,28.0,17.0,11.0,28.0,17.0,11.0,2005,,1998-2008
557,557,Pat Riley,MIA,9,22,61,41,20,685,395,290,1740,1151,589,0.6609999999999999,23.0,16.0,7.0,66.0,34.0,32.0,278.0,171.0,107.0,2005,0.6956521739130435,1998-2008
558,558,Terry Stotts,MIL,1,3,82,40,42,82,40,42,219,92,127,0.42,5.0,1.0,4.0,5.0,1.0,4.0,5.0,1.0,4.0,2005,0.2,1998-2008
559,559,Dwane Casey,MIN,1,1,82,33,49,82,33,49,82,33,49,0.402,,,,,,,,,,2005,,1998-2008
560,560,Lawrence Frank,BRK,3,3,82,49,33,204,116,88,204,116,88,0.569,11.0,5.0,6.0,26.0,12.0,14.0,26.0,12.0,14.0,2005,0.45454545454545453,1998-2008
561,561,Byron Scott,NOP,2,6,82,38,44,164,56,108,452,205,247,0.454,,,,,,,40.0,25.0,15.0,2005,,1998-2008
562,562,Larry Brown,NYK,1,27,82,23,59,82,23,59,2146,1239,907,0.5770000000000001,,,,,,,231.0,120.0,111.0,2005,,1998-2008
563,563,Brian Hill,ORL,5,8,82,36,46,377,227,150,531,258,273,0.486,,,,36.0,18.0,18.0,36.0,18.0,18.0,2005,,1998-2008
564,564,Maurice Cheeks,PHI,1,5,82,38,44,82,38,44,383,200,183,0.522,,,,,,,10.0,3.0,7.0,2005,,1998-2008
565,565,Mike D'Antoni,PHO,3,4,82,54,28,225,137,88,275,151,124,0.5489999999999999,20.0,10.0,10.0,35.0,19.0,16.0,35.0,19.0,16.0,2005,0.5,1998-2008
566,566,Nate McMillan,POR,1,6,82,21,61,82,21,61,477,233,244,0.488,,,,,,,16.0,8.0,8.0,2005,,1998-2008
567,567,Rick Adelman,SAC,8,16,82,44,38,624,395,229,1233,752,481,0.61,6.0,2.0,4.0,69.0,34.0,35.0,138.0,70.0,68.0,2005,0.3333333333333333,1998-2008
568,568,Gregg Popovich,SAS,10,10,82,63,19,770,518,252,770,518,252,0.6729999999999999,13.0,7.0,6.0,123.0,76.0,47.0,123.0,76.0,47.0,2005,0.5384615384615384,1998-2008
570,570,Bob Hill,OKC,1,8,52,22,30,52,22,30,521,279,242,0.536,,,,,,,37.0,17.0,20.0,2005,,1998-2008
572,572,Jerry Sloan,UTA,18,21,82,41,41,1427,890,537,1642,984,658,0.599,,,,152.0,76.0,76.0,158.0,78.0,80.0,2005,,1998-2008
573,573,Eddie Jordan,WAS,3,5,82,42,40,246,112,134,343,145,198,0.423,6.0,2.0,4.0,16.0,6.0,10.0,16.0,6.0,10.0,2005,0.3333333333333333,1998-2008
574,574,Kevin Loughery,ATL,2,11,82,43,39,164,85,79,810,387,423,0.478,3.0,1.0,2.0,5.0,1.0,4.0,39.0,22.0,17.0,1982,0.3333333333333333,1979-1988
575,575,Bill Fitch,BOS,4,13,82,56,26,328,242,86,1066,546,520,0.512,7.0,2.0,5.0,45.0,26.0,19.0,63.0,33.0,30.0,1982,0.2857142857142857,1979-1988
577,577,Tom Nissalke,CLE,1,12,82,23,59,82,23,59,797,343,454,0.43,,,,,,,31.0,11.0,20.0,1982,,1979-1988
578,578,Dick Motta,DAL,3,15,82,38,44,246,81,165,1230,622,608,0.506,,,,,,,98.0,45.0,53.0,1982,,1979-1988
579,579,Doug Moe,DEN,3,7,82,45,37,215,117,98,527,294,233,0.5579999999999999,8.0,3.0,5.0,11.0,4.0,7.0,33.0,13.0,20.0,1982,0.375,1979-1988
581,581,Al Attles,GSW,14,14,82,30,52,1075,557,518,1075,557,518,0.518,,,,61.0,31.0,30.0,61.0,31.0,30.0,1982,,1979-1988
582,582,Del Harris,HOU,4,4,82,14,68,328,141,187,328,141,187,0.43,,,,31.0,15.0,16.0,31.0,15.0,16.0,1982,,1979-1988
584,584,Cotton Fitzsimmons,SAC,5,12,82,45,37,410,210,200,976,474,502,0.486,,,,23.0,9.0,14.0,29.0,11.0,18.0,1982,,1979-1988
585,585,Pat Riley,LAL,2,2,82,58,24,153,108,45,153,108,45,0.706,15.0,8.0,7.0,29.0,20.0,9.0,29.0,20.0,9.0,1982,0.5333333333333333,1979-1988
586,586,Don Nelson,MIL,7,7,82,51,31,556,324,232,556,324,232,0.583,9.0,5.0,4.0,38.0,18.0,20.0,38.0,18.0,20.0,1982,0.5555555555555556,1979-1988
587,587,Larry Brown,BRK,2,9,76,47,29,158,91,67,711,446,265,0.627,,,,2.0,0.0,2.0,63.0,28.0,35.0,1982,,1979-1988
589,589,Hubie Brown,NYK,1,8,82,44,38,82,44,38,657,347,310,0.528,6.0,2.0,4.0,6.0,2.0,4.0,47.0,25.0,22.0,1982,0.3333333333333333,1979-1988
590,590,Billy Cunningham,PHI,6,6,82,65,17,486,344,142,486,344,142,0.708,13.0,12.0,1.0,87.0,56.0,31.0,87.0,56.0,31.0,1982,0.9230769230769231,1979-1988
591,591,John MacLeod,PHO,10,10,82,53,29,820,448,372,820,448,372,0.546,3.0,1.0,2.0,61.0,28.0,33.0,61.0,28.0,33.0,1982,0.3333333333333333,1979-1988
592,592,Jack Ramsay,POR,7,15,82,46,36,574,323,251,1230,655,575,0.5329999999999999,7.0,3.0,4.0,41.0,22.0,19.0,80.0,36.0,44.0,1982,0.42857142857142855,1979-1988
594,594,Paul Silas,LAC,3,3,82,25,57,246,78,168,246,78,168,0.317,,,,,,,,,,1982,,1979-1988
595,595,Lenny Wilkens,OKC,9,11,82,48,34,716,405,311,880,480,400,0.545,2.0,0.0,2.0,64.0,35.0,29.0,64.0,35.0,29.0,1982,0.0,1979-1988
596,596,Frank Layden,UTA,2,2,82,30,52,144,47,97,144,47,97,0.326,,,,,,,,,,1982,,1979-1988
597,597,Gene Shue,WAS,10,17,82,42,40,794,415,379,1292,650,642,0.503,,,,47.0,17.0,30.0,69.0,28.0,41.0,1982,,1979-1988
598,598,Cotton Fitzsimmons,ATL,1,3,82,46,36,82,46,36,246,143,103,0.581,6.0,2.0,4.0,6.0,2.0,4.0,6.0,2.0,4.0,1972,0.3333333333333333,1969-1979
599,599,Gene Shue,WAS,7,7,82,52,30,548,291,257,548,291,257,0.531,5.0,1.0,4.0,40.0,14.0,26.0,40.0,14.0,26.0,1972,0.2,1969-1979
600,600,Tom Heinsohn,BOS,4,4,82,68,14,328,202,126,328,202,126,0.616,13.0,7.0,6.0,24.0,12.0,12.0,24.0,12.0,12.0,1972,0.5384615384615384,1969-1979
601,601,Jack Ramsay,LAC,1,5,82,21,61,82,21,61,410,195,215,0.476,,,,,,,17.0,5.0,12.0,1972,,1969-1979
602,602,Dick Motta,CHI,5,5,82,51,31,410,231,179,410,231,179,0.563,7.0,3.0,4.0,23.0,7.0,16.0,23.0,7.0,16.0,1972,0.42857142857142855,1969-1979
603,603,Bill Fitch,CLE,3,3,82,32,50,246,70,176,246,70,176,0.285,,,,,,,,,,1972,,1969-1979
606,606,Al Attles,GSW,4,4,82,47,35,276,147,129,276,147,129,0.5329999999999999,11.0,5.0,6.0,21.0,7.0,14.0,21.0,7.0,14.0,1972,0.45454545454545453,1969-1979
611,611,Larry Costello,MIL,5,5,82,60,22,410,272,138,410,272,138,0.6629999999999999,6.0,2.0,4.0,41.0,25.0,16.0,41.0,25.0,16.0,1972,0.3333333333333333,1969-1979
612,612,Red Holzman,NYK,6,10,82,57,25,454,299,155,657,382,275,0.581,17.0,12.0,5.0,80.0,48.0,32.0,88.0,52.0,36.0,1972,0.7058823529411765,1969-1979
614,614,Kevin Loughery,PHI,1,1,31,5,26,31,5,26,31,5,26,0.161,,,,,,,,,,1972,,1969-1979
615,615,Butch van Breda Kolff,PHO,1,6,7,3,4,7,3,4,345,192,153,0.557,,,,,,,33.0,21.0,12.0,1972,,1969-1979
618,618,Tom Nissalke,OKC,1,2,45,13,32,45,13,32,129,55,74,0.426,,,,,,,4.0,0.0,4.0,1972,,1969-1979
620,620,Mike Woodson,ATL,4,4,82,37,45,328,106,222,328,106,222,0.32299999999999995,7.0,3.0,4.0,7.0,3.0,4.0,7.0,3.0,4.0,2007,0.42857142857142855,1998-2008
621,621,Doc Rivers,BOS,4,9,82,66,16,328,168,160,667,339,328,0.508,26.0,16.0,10.0,33.0,19.0,14.0,48.0,24.0,24.0,2007,0.6153846153846154,1998-2008
623,623,Scott Skiles,CHI,5,8,25,9,16,337,165,172,532,281,251,0.528,,,,22.0,10.0,12.0,35.0,15.0,20.0,2007,,1998-2008
626,626,Mike Brown,CLE,3,3,82,45,37,246,145,101,246,145,101,0.589,13.0,7.0,6.0,46.0,26.0,20.0,46.0,26.0,20.0,2007,0.5384615384615384,1998-2008
628,628,George Karl,DEN,4,20,82,50,32,286,171,115,1493,879,614,0.589,4.0,0.0,4.0,19.0,3.0,16.0,145.0,62.0,83.0,2007,0.0,1998-2008
629,629,Flip Saunders,DET,3,13,82,59,23,246,176,70,983,587,396,0.597,17.0,10.0,7.0,51.0,30.0,21.0,98.0,47.0,51.0,2007,0.5882352941176471,1998-2008
630,630,Don Nelson,GSW,9,29,82,48,34,701,367,334,2234,1280,954,0.573,,,,35.0,14.0,21.0,166.0,75.0,91.0,2007,,1998-2008
631,631,Rick Adelman,HOU,1,17,82,55,27,82,55,27,1315,807,508,0.614,6.0,2.0,4.0,6.0,2.0,4.0,144.0,72.0,72.0,2007,0.3333333333333333,1998-2008
632,632,Jim O'Brien,IND,1,6,82,36,46,82,36,46,422,218,204,0.517,,,,,,,31.0,14.0,17.0,2007,,1998-2008
633,633,Mike Dunleavy,LAC,5,15,82,23,59,410,175,235,1198,573,625,0.478,,,,12.0,7.0,5.0,71.0,38.0,33.0,2007,,1998-2008
634,634,Phil Jackson,LAL,8,17,82,57,25,656,431,225,1394,976,418,0.7,21.0,14.0,7.0,125.0,82.0,43.0,277.0,193.0,84.0,2007,0.6666666666666666,1998-2008
636,636,Pat Riley,MIA,11,24,82,15,67,849,454,395,1904,1210,694,0.636,,,,70.0,34.0,36.0,282.0,171.0,111.0,2007,,1998-2008
638,638,Randy Wittman,MIN,2,4,82,22,60,124,34,90,288,96,192,0.333,,,,,,,,,,2007,,1998-2008
639,639,Lawrence Frank,BRK,5,5,82,34,48,368,191,177,368,191,177,0.519,,,,38.0,18.0,20.0,38.0,18.0,20.0,2007,,1998-2008
640,640,Byron Scott,NOP,4,8,82,56,26,328,151,177,616,300,316,0.487,12.0,7.0,5.0,12.0,7.0,5.0,52.0,32.0,20.0,2007,0.5833333333333334,1998-2008
642,642,Stan Van Gundy,ORL,1,4,82,52,30,82,52,30,267,164,103,0.614,10.0,5.0,5.0,10.0,5.0,5.0,38.0,22.0,16.0,2007,0.5,1998-2008
643,643,Maurice Cheeks,PHI,3,7,82,40,42,246,113,133,547,275,272,0.503,6.0,2.0,4.0,6.0,2.0,4.0,16.0,5.0,11.0,2007,0.3333333333333333,1998-2008
644,644,Mike D'Antoni,PHO,5,6,82,55,27,389,253,136,439,267,172,0.608,5.0,1.0,4.0,51.0,26.0,25.0,51.0,26.0,25.0,2007,0.2,1998-2008
645,645,Nate McMillan,POR,3,8,82,41,41,246,94,152,641,306,335,0.477,,,,,,,16.0,8.0,8.0,2007,,1998-2008
647,647,Gregg Popovich,SAS,12,12,82,56,26,934,632,302,934,632,302,0.677,17.0,9.0,8.0,160.0,101.0,59.0,160.0,101.0,59.0,2007,0.5294117647058824,1998-2008
648,648,P.J. Carlesimo,OKC,1,7,82,20,62,82,20,62,487,203,284,0.417,,,,,,,12.0,3.0,9.0,2007,,1998-2008
650,650,Jerry Sloan,UTA,20,23,82,54,28,1591,995,596,1806,1089,717,0.603,12.0,6.0,6.0,181.0,91.0,90.0,187.0,93.0,94.0,2007,0.5,1998-2008
651,651,Eddie Jordan,WAS,5,7,82,43,39,410,196,214,507,229,278,0.452,6.0,2.0,4.0,26.0,8.0,18.0,26.0,8.0,18.0,2007,0.3333333333333333,1998-2008
652,652,Richie Guerin,ATL,6,6,82,48,34,454,255,199,454,255,199,0.562,9.0,4.0,5.0,49.0,23.0,26.0,49.0,23.0,26.0,1969,0.4444444444444444,1959-69
653,653,Gene Shue,WAS,4,4,82,50,32,302,159,143,302,159,143,0.526,7.0,3.0,4.0,11.0,3.0,8.0,11.0,3.0,8.0,1969,0.42857142857142855,1959-69
654,654,Tom Heinsohn,BOS,1,1,82,34,48,82,34,48,82,34,48,0.415,,,,,,,,,,1969,,1959-69
655,655,Dick Motta,CHI,2,2,82,39,43,164,72,92,164,72,92,0.439,5.0,1.0,4.0,5.0,1.0,4.0,5.0,1.0,4.0,1969,0.2,1959-69
657,657,Butch van Breda Kolff,DET,1,3,82,31,51,82,31,51,246,138,108,0.561,,,,,,,33.0,21.0,12.0,1969,,1959-69
659,659,Larry Costello,MIL,2,2,82,56,26,164,83,81,164,83,81,0.506,10.0,5.0,5.0,10.0,5.0,5.0,10.0,5.0,5.0,1969,0.5,1959-69
660,660,Red Holzman,NYK,3,7,82,60,22,208,142,66,411,225,186,0.547,19.0,12.0,7.0,35.0,20.0,15.0,43.0,24.0,19.0,1969,0.631578947368421,1959-69
661,661,Jack Ramsay,PHI,2,2,82,42,40,164,97,67,164,97,67,0.591,5.0,1.0,4.0,10.0,2.0,8.0,10.0,2.0,8.0,1969,0.2,1959-69
664,664,Jack McMahon,HOU,3,8,26,9,17,190,61,129,549,260,289,0.474,,,,6.0,2.0,4.0,29.0,10.0,19.0,1969,,1959-69
665,665,Alex Hannum,HOU,1,12,56,18,38,56,18,38,879,491,388,0.5589999999999999,,,,,,,95.0,57.0,38.0,1969,,1959-69
666,666,Lenny Wilkens,OKC,1,1,82,36,46,82,36,46,82,36,46,0.439,,,,,,,,,,1969,,1959-69
668,668,Al Attles,GSW,1,1,30,8,22,30,8,22,30,8,22,0.267,,,,,,,,,,1969,,1959-69
670,670,Doc Rivers,BOS,9,14,81,41,40,721,416,305,1060,587,473,0.5539999999999999,6.0,2.0,4.0,106.0,59.0,47.0,121.0,64.0,57.0,2012,0.3333333333333333,2008-2018
672,672,P.J. Carlesimo,BRK,1,9,54,35,19,54,35,19,554,239,315,0.431,7.0,3.0,4.0,7.0,3.0,4.0,19.0,6.0,13.0,2012,0.42857142857142855,2008-2018
674,674,Tom Thibodeau,CHI,3,3,82,45,37,230,157,73,230,157,73,0.6829999999999999,12.0,5.0,7.0,34.0,16.0,18.0,34.0,16.0,18.0,2012,0.4166666666666667,2008-2018
675,675,Byron Scott,CLE,3,13,82,24,58,230,64,166,937,416,521,0.444,,,,,,,57.0,33.0,24.0,2012,,2008-2018
676,676,Rick Carlisle,DAL,5,11,82,41,41,394,239,155,886,520,366,0.5870000000000001,,,,41.0,23.0,18.0,103.0,53.0,50.0,2012,,2008-2018
677,677,George Karl,DEN,9,25,82,57,25,680,423,257,1887,1131,756,0.599,6.0,2.0,4.0,59.0,21.0,38.0,185.0,80.0,105.0,2012,0.3333333333333333,2008-2018
678,678,Lawrence Frank,DET,2,9,82,29,53,148,54,94,614,279,335,0.454,,,,,,,38.0,18.0,20.0,2012,,2008-2018
681,681,Frank Vogel,IND,3,3,81,49,32,185,111,74,185,111,74,0.6,19.0,11.0,8.0,35.0,18.0,17.0,35.0,18.0,17.0,2012,0.5789473684210527,2008-2018
683,683,Mike Brown,LAL,2,7,5,1,4,71,42,29,481,314,167,0.653,,,,12.0,5.0,7.0,83.0,47.0,36.0,2012,,2008-2018
684,684,Bernie Bickerstaff,LAL,1,14,5,4,1,5,4,1,937,419,518,0.447,,,,,,,33.0,12.0,21.0,2012,,2008-2018
685,685,Mike D'Antoni,LAL,1,11,72,40,32,72,40,32,799,428,371,0.536,4.0,0.0,4.0,4.0,0.0,4.0,59.0,26.0,33.0,2012,0.0,2008-2018
686,686,Lionel Hollins,MEM,7,7,82,56,26,415,214,201,415,214,201,0.516,15.0,8.0,7.0,35.0,18.0,17.0,35.0,18.0,17.0,2012,0.5333333333333333,2008-2018
687,687,Erik Spoelstra,MIA,5,5,82,66,16,394,260,134,394,260,134,0.66,23.0,16.0,7.0,79.0,50.0,29.0,79.0,50.0,29.0,2012,0.6956521739130435,2008-2018
688,688,Scott Skiles,MIL,5,13,32,16,16,344,162,182,876,443,433,0.506,,,,7.0,3.0,4.0,42.0,18.0,24.0,2012,,2008-2018
690,690,Rick Adelman,MIN,2,22,82,31,51,148,57,91,1709,1002,707,0.586,,,,,,,157.0,79.0,78.0,2012,,2008-2018
692,692,Mike Woodson,NYK,2,8,82,54,28,106,72,34,598,278,320,0.465,12.0,6.0,6.0,17.0,7.0,10.0,46.0,18.0,28.0,2012,0.5,2008-2018
693,693,Scott Brooks,OKC,5,5,82,60,22,381,234,147,381,234,147,0.614,11.0,5.0,6.0,54.0,29.0,25.0,54.0,29.0,25.0,2012,0.45454545454545453,2008-2018
695,695,Doug Collins,PHI,3,11,82,34,48,230,110,120,849,442,407,0.521,,,,18.0,8.0,10.0,56.0,23.0,33.0,2012,,2008-2018
696,696,Alvin Gentry,PHO,5,12,41,13,28,302,158,144,705,335,370,0.475,,,,16.0,10.0,6.0,21.0,12.0,9.0,2012,,2008-2018
698,698,Terry Stotts,POR,1,5,82,33,49,82,33,49,365,148,217,0.405,,,,,,,5.0,1.0,4.0,2012,,2008-2018
700,700,Gregg Popovich,SAS,17,17,82,58,24,1328,905,423,1328,905,423,0.6809999999999999,21.0,15.0,6.0,216.0,133.0,83.0,216.0,133.0,83.0,2012,0.7142857142857143,2008-2018
701,701,Dwane Casey,TOR,2,4,82,34,48,148,57,91,270,110,160,0.407,,,,,,,,,,2012,,2008-2018
703,703,Randy Wittman,WAS,2,7,82,29,53,131,47,84,438,147,291,0.336,,,,,,,,,,2012,,2008-2018
704,704,Cotton Fitzsimmons,ATL,4,6,74,28,46,320,140,180,484,237,247,0.49,,,,6.0,2.0,4.0,6.0,2.0,4.0,1975,,1969-1979
706,706,Tom Heinsohn,BOS,7,7,82,54,28,574,372,202,574,372,202,0.648,18.0,12.0,6.0,71.0,42.0,29.0,71.0,42.0,29.0,1975,0.6666666666666666,1969-1979
707,707,Jack Ramsay,LAC,4,8,82,46,36,328,158,170,656,332,324,0.506,9.0,4.0,5.0,22.0,9.0,13.0,39.0,14.0,25.0,1975,0.4444444444444444,1969-1979
708,708,Dick Motta,CHI,8,8,82,24,58,656,356,300,656,356,300,0.5429999999999999,,,,47.0,18.0,29.0,47.0,18.0,29.0,1975,,1969-1979
709,709,Bill Fitch,CLE,6,6,82,49,33,492,188,304,492,188,304,0.382,13.0,6.0,7.0,13.0,6.0,7.0,13.0,6.0,7.0,1975,0.46153846153846156,1969-1979
712,712,Al Attles,GSW,7,7,82,59,23,522,298,224,522,298,224,0.5710000000000001,13.0,7.0,6.0,51.0,26.0,25.0,51.0,26.0,25.0,1975,0.5384615384615384,1969-1979
714,714,Phil Johnson,SAC,3,3,82,31,51,222,102,120,222,102,120,0.459,,,,6.0,2.0,4.0,6.0,2.0,4.0,1975,,1969-1979
716,716,Larry Costello,MIL,8,8,82,38,44,656,407,249,656,407,249,0.62,3.0,1.0,2.0,60.0,37.0,23.0,60.0,37.0,23.0,1975,0.3333333333333333,1969-1979
717,717,Butch van Breda Kolff,UTA,2,9,82,38,44,148,60,88,577,273,304,0.473,,,,,,,33.0,21.0,12.0,1975,,1969-1979
718,718,Red Holzman,NYK,9,13,82,38,44,700,426,274,903,509,394,0.564,,,,95.0,54.0,41.0,103.0,58.0,45.0,1975,,1969-1979
719,719,Gene Shue,PHI,3,10,82,46,36,246,105,141,794,396,398,0.499,3.0,1.0,2.0,3.0,1.0,2.0,43.0,15.0,28.0,1975,0.3333333333333333,1969-1979
720,720,John MacLeod,PHO,3,3,82,42,40,246,104,142,246,104,142,0.423,19.0,10.0,9.0,19.0,10.0,9.0,19.0,10.0,9.0,1975,0.5263157894736842,1969-1979
721,721,Lenny Wilkens,POR,2,5,82,37,45,164,75,89,410,196,214,0.478,,,,,,,,,,1975,,1969-1979
722,722,Bill Russell,OKC,3,6,82,43,39,246,122,124,491,284,207,0.578,6.0,2.0,4.0,15.0,6.0,9.0,61.0,34.0,27.0,1975,0.3333333333333333,1969-1979
723,723,K.C. Jones,WAS,3,4,82,48,34,246,155,91,330,185,145,0.561,7.0,3.0,4.0,31.0,14.0,17.0,35.0,14.0,21.0,1975,0.42857142857142855,1969-1979
725,725,Doc Rivers,BOS,8,13,66,39,27,640,375,265,979,546,433,0.5579999999999999,20.0,11.0,9.0,100.0,57.0,43.0,115.0,62.0,53.0,2011,0.55,2008-2018
726,726,Paul Silas,CHO,6,12,66,7,59,401,193,208,875,387,488,0.442,,,,23.0,11.0,12.0,29.0,13.0,16.0,2011,,2008-2018
727,727,Tom Thibodeau,CHI,2,2,66,50,16,148,112,36,148,112,36,0.757,6.0,2.0,4.0,22.0,11.0,11.0,22.0,11.0,11.0,2011,0.3333333333333333,2008-2018
728,728,Byron Scott,CLE,2,12,66,21,45,148,40,108,855,392,463,0.458,,,,,,,57.0,33.0,24.0,2011,,2008-2018
729,729,Rick Carlisle,DAL,4,10,66,36,30,312,198,114,804,479,325,0.596,4.0,0.0,4.0,41.0,23.0,18.0,103.0,53.0,50.0,2011,0.0,2008-2018
730,730,George Karl,DEN,8,24,66,38,28,598,366,232,1805,1074,731,0.595,7.0,3.0,4.0,53.0,19.0,34.0,179.0,78.0,101.0,2011,0.42857142857142855,2008-2018
731,731,Lawrence Frank,DET,1,8,66,25,41,66,25,41,532,250,282,0.47,,,,,,,38.0,18.0,20.0,2011,,2008-2018
734,734,Frank Vogel,IND,2,2,66,42,24,104,62,42,104,62,42,0.596,11.0,6.0,5.0,16.0,7.0,9.0,16.0,7.0,9.0,2011,0.5454545454545454,2008-2018
736,736,Mike Brown,LAL,1,6,66,41,25,66,41,25,476,313,163,0.6579999999999999,12.0,5.0,7.0,12.0,5.0,7.0,83.0,47.0,36.0,2011,0.4166666666666667,2008-2018
737,737,Lionel Hollins,MEM,6,6,66,41,25,333,158,175,333,158,175,0.474,7.0,3.0,4.0,20.0,10.0,10.0,20.0,10.0,10.0,2011,0.42857142857142855,2008-2018
738,738,Erik Spoelstra,MIA,4,4,66,46,20,312,194,118,312,194,118,0.622,23.0,16.0,7.0,56.0,34.0,22.0,56.0,34.0,22.0,2011,0.6956521739130435,2008-2018
739,739,Scott Skiles,MIL,4,12,66,31,35,312,146,166,844,427,417,0.506,,,,7.0,3.0,4.0,42.0,18.0,24.0,2011,,2008-2018
740,740,Rick Adelman,MIN,1,21,66,26,40,66,26,40,1627,971,656,0.597,,,,,,,157.0,79.0,78.0,2011,,2008-2018
743,743,Mike D'Antoni,NYK,4,10,42,18,24,288,121,167,727,388,339,0.534,,,,4.0,0.0,4.0,55.0,26.0,29.0,2011,,2008-2018
744,744,Mike Woodson,NYK,1,7,24,18,6,24,18,6,516,224,292,0.434,5.0,1.0,4.0,5.0,1.0,4.0,34.0,12.0,22.0,2011,0.2,2008-2018
745,745,Scott Brooks,OKC,4,4,66,47,19,299,174,125,299,174,125,0.5820000000000001,20.0,13.0,7.0,43.0,24.0,19.0,43.0,24.0,19.0,2011,0.65,2008-2018
746,746,Stan Van Gundy,ORL,5,8,66,37,29,394,259,135,579,371,208,0.6409999999999999,5.0,1.0,4.0,59.0,31.0,28.0,87.0,48.0,39.0,2011,0.2,2008-2018
747,747,Doug Collins,PHI,2,10,66,35,31,148,76,72,767,408,359,0.532,13.0,7.0,6.0,18.0,8.0,10.0,56.0,23.0,33.0,2011,0.5384615384615384,2008-2018
748,748,Alvin Gentry,PHO,4,11,66,33,33,261,145,116,664,322,342,0.485,,,,16.0,10.0,6.0,21.0,12.0,9.0,2011,,2008-2018
749,749,Nate McMillan,POR,7,12,43,20,23,535,266,269,930,478,452,0.514,,,,18.0,6.0,12.0,34.0,14.0,20.0,2011,,2008-2018
751,751,Paul Westphal,SAC,3,10,7,2,5,171,51,120,597,318,279,0.5329999999999999,,,,,,,49.0,27.0,22.0,2011,,2008-2018
753,753,Gregg Popovich,SAS,16,16,66,50,16,1246,847,399,1246,847,399,0.68,14.0,10.0,4.0,195.0,118.0,77.0,195.0,118.0,77.0,2011,0.7142857142857143,2008-2018
754,754,Dwane Casey,TOR,1,3,66,23,43,66,23,43,188,76,112,0.404,,,,,,,,,,2011,,2008-2018
756,756,Flip Saunders,WAS,3,16,17,2,15,181,51,130,1164,638,526,0.5479999999999999,,,,,,,98.0,47.0,51.0,2011,,2008-2018
757,757,Randy Wittman,WAS,1,6,49,18,31,49,18,31,356,118,238,0.331,,,,,,,,,,2011,,2008-2018
758,758,Hubie Brown,ATL,1,3,82,31,51,82,31,51,250,135,115,0.54,,,,,,,25.0,17.0,8.0,1976,,1969-1979
759,759,Tom Heinsohn,BOS,8,8,82,44,38,656,416,240,656,416,240,0.634,9.0,5.0,4.0,80.0,47.0,33.0,80.0,47.0,33.0,1976,0.5555555555555556,1969-1979
764,764,Bill Fitch,CLE,7,7,82,43,39,574,231,343,574,231,343,0.402,3.0,1.0,2.0,16.0,7.0,9.0,16.0,7.0,9.0,1976,0.3333333333333333,1969-1979
765,765,Larry Brown,DEN,3,5,82,50,32,250,175,75,418,279,139,0.667,6.0,2.0,4.0,32.0,15.0,17.0,48.0,22.0,26.0,1976,0.3333333333333333,1969-1979
767,767,Al Attles,GSW,8,8,82,46,36,604,344,260,604,344,260,0.57,10.0,5.0,5.0,61.0,31.0,30.0,61.0,31.0,30.0,1976,0.5,1969-1979
768,768,Tom Nissalke,HOU,1,6,82,49,33,82,49,33,367,185,182,0.504,12.0,6.0,6.0,12.0,6.0,6.0,29.0,11.0,18.0,1976,0.5,1969-1979
770,770,Phil Johnson,SAC,4,4,82,40,42,304,142,162,304,142,162,0.467,,,,6.0,2.0,4.0,6.0,2.0,4.0,1976,,1969-1979
772,772,Larry Costello,MIL,9,9,18,3,15,674,410,264,674,410,264,0.608,,,,60.0,37.0,23.0,60.0,37.0,23.0,1976,,1969-1979
773,773,Don Nelson,MIL,1,1,64,27,37,64,27,37,64,27,37,0.422,,,,,,,,,,1976,,1969-1979
774,774,Butch van Breda Kolff,UTA,3,10,26,14,12,174,74,100,603,287,316,0.476,,,,,,,33.0,21.0,12.0,1976,,1969-1979
776,776,Red Holzman,NYK,10,14,82,40,42,782,466,316,985,549,436,0.557,,,,95.0,54.0,41.0,103.0,58.0,45.0,1976,,1969-1979
777,777,Kevin Loughery,BRK,4,5,82,22,60,334,190,144,365,195,170,0.534,,,,32.0,21.0,11.0,32.0,21.0,11.0,1976,,1969-1979
778,778,Gene Shue,PHI,4,11,82,50,32,328,155,173,876,446,430,0.509,19.0,10.0,9.0,22.0,11.0,11.0,62.0,25.0,37.0,1976,0.5263157894736842,1969-1979
779,779,John MacLeod,PHO,4,4,82,34,48,328,138,190,328,138,190,0.421,,,,19.0,10.0,9.0,19.0,10.0,9.0,1976,,1969-1979
780,780,Jack Ramsay,POR,1,9,82,49,33,82,49,33,738,381,357,0.516,19.0,14.0,5.0,19.0,14.0,5.0,58.0,28.0,30.0,1976,0.7368421052631579,1969-1979
781,781,Doug Moe,SAS,1,1,82,44,38,82,44,38,82,44,38,0.537,2.0,0.0,2.0,2.0,0.0,2.0,2.0,0.0,2.0,1976,0.0,1969-1979
782,782,Bill Russell,OKC,4,7,82,40,42,328,162,166,573,324,249,0.565,,,,15.0,6.0,9.0,61.0,34.0,27.0,1976,,1969-1979
783,783,Dick Motta,WAS,1,9,82,48,34,82,48,34,738,404,334,0.547,9.0,4.0,5.0,9.0,4.0,5.0,56.0,22.0,34.0,1976,0.4444444444444444,1969-1979
784,784,Red Auerbach,BOS,7,11,72,44,28,494,285,209,719,428,291,0.595,10.0,7.0,3.0,37.0,17.0,20.0,57.0,26.0,31.0,1956,0.7,1950-59
786,786,John Kundla,LAL,9,9,72,34,38,620,380,240,620,380,240,0.613,5.0,2.0,3.0,82.0,54.0,28.0,82.0,54.0,28.0,1956,0.4,1950-59
790,790,Red Holzman,ATL,4,4,33,14,19,203,83,120,203,83,120,0.409,,,,8.0,4.0,4.0,8.0,4.0,4.0,1956,,1950-59
792,792,Alex Hannum,ATL,1,1,31,15,16,31,15,16,31,15,16,0.484,10.0,6.0,4.0,10.0,6.0,4.0,10.0,6.0,4.0,1956,0.6,1950-59
793,793,Al Cervi,PHI,8,8,12,4,8,495,294,201,495,294,201,0.594,,,,59.0,33.0,26.0,59.0,33.0,26.0,1956,,1950-59
794,794,Paul Seymour,PHI,1,1,60,34,26,60,34,26,60,34,26,0.5670000000000001,5.0,2.0,3.0,5.0,2.0,3.0,5.0,2.0,3.0,1956,0.4,1950-59
795,795,Hubie Brown,ATL,2,4,82,41,41,164,72,92,332,176,156,0.53,2.0,0.0,2.0,2.0,0.0,2.0,27.0,17.0,10.0,1977,0.0,1969-1979
796,796,Tom Heinsohn,BOS,9,9,34,11,23,690,427,263,690,427,263,0.619,,,,80.0,47.0,33.0,80.0,47.0,33.0,1977,,1969-1979
798,798,Cotton Fitzsimmons,LAC,1,7,82,27,55,82,27,55,566,264,302,0.466,,,,,,,6.0,2.0,4.0,1977,,1969-1979
800,800,Bill Fitch,CLE,8,8,82,43,39,656,274,382,656,274,382,0.418,2.0,0.0,2.0,18.0,7.0,11.0,18.0,7.0,11.0,1977,0.0,1969-1979
801,801,Larry Brown,DEN,4,6,82,48,34,332,223,109,500,327,173,0.654,13.0,6.0,7.0,45.0,21.0,24.0,61.0,28.0,33.0,1977,0.46153846153846156,1969-1979
804,804,Al Attles,GSW,9,9,82,43,39,686,387,299,686,387,299,0.564,,,,61.0,31.0,30.0,61.0,31.0,30.0,1977,,1969-1979
805,805,Tom Nissalke,HOU,2,7,82,28,54,164,77,87,449,213,236,0.474,,,,12.0,6.0,6.0,29.0,11.0,18.0,1977,,1969-1979
807,807,Phil Johnson,SAC,5,5,37,13,24,341,155,186,341,155,186,0.455,,,,6.0,2.0,4.0,6.0,2.0,4.0,1977,,1969-1979
810,810,Don Nelson,MIL,2,2,82,44,38,146,71,75,146,71,75,0.486,9.0,5.0,4.0,9.0,5.0,4.0,9.0,5.0,4.0,1977,0.5555555555555556,1969-1979
811,811,Kevin Loughery,BRK,5,6,82,24,58,416,214,202,447,219,228,0.49,,,,32.0,21.0,11.0,32.0,21.0,11.0,1977,,1969-1979
814,814,Gene Shue,PHI,5,12,6,2,4,334,157,177,882,448,434,0.508,,,,22.0,11.0,11.0,62.0,25.0,37.0,1977,,1969-1979
815,815,Billy Cunningham,PHI,1,1,76,53,23,76,53,23,76,53,23,0.6970000000000001,10.0,6.0,4.0,10.0,6.0,4.0,10.0,6.0,4.0,1977,0.6,1969-1979
816,816,John MacLeod,PHO,5,5,82,49,33,410,187,223,410,187,223,0.456,2.0,0.0,2.0,21.0,10.0,11.0,21.0,10.0,11.0,1977,0.0,1969-1979
817,817,Jack Ramsay,POR,2,10,82,58,24,164,107,57,820,439,381,0.535,6.0,2.0,4.0,25.0,16.0,9.0,64.0,30.0,34.0,1977,0.3333333333333333,1969-1979
818,818,Doug Moe,SAS,2,2,82,52,30,164,96,68,164,96,68,0.585,6.0,2.0,4.0,8.0,2.0,6.0,8.0,2.0,6.0,1977,0.3333333333333333,1969-1979
820,820,Lenny Wilkens,OKC,4,6,60,42,18,306,163,143,470,238,232,0.506,22.0,13.0,9.0,22.0,13.0,9.0,22.0,13.0,9.0,1977,0.5909090909090909,1969-1979
821,821,Dick Motta,WAS,2,10,82,44,38,164,92,72,820,448,372,0.546,21.0,14.0,7.0,30.0,18.0,12.0,77.0,36.0,41.0,1977,0.6666666666666666,1969-1979
822,822,Paul Seymour,WAS,1,7,80,38,42,80,38,42,452,249,203,0.551,3.0,0.0,3.0,3.0,0.0,3.0,35.0,14.0,21.0,1965,0.0,1959-69
823,823,Red Auerbach,BOS,16,20,80,54,26,1192,795,397,1417,938,479,0.662,17.0,11.0,6.0,148.0,90.0,58.0,168.0,99.0,69.0,1965,0.6470588235294118,1959-69
824,824,Jack McMahon,SAC,3,4,80,45,35,240,148,92,278,160,118,0.5760000000000001,5.0,2.0,3.0,19.0,7.0,12.0,19.0,7.0,12.0,1965,0.4,1959-69
830,830,Alex Hannum,GSW,3,8,80,35,45,240,100,140,582,283,299,0.486,,,,12.0,5.0,7.0,51.0,27.0,24.0,1965,,1959-69
831,831,Richie Guerin,ATL,2,2,80,36,44,127,64,63,127,64,63,0.504,10.0,6.0,4.0,14.0,7.0,7.0,14.0,7.0,7.0,1965,0.6,1959-69
833,833,Red Auerbach,BOS,15,19,80,62,18,1112,741,371,1337,884,453,0.6609999999999999,12.0,8.0,4.0,131.0,79.0,52.0,151.0,88.0,63.0,1964,0.6666666666666666,1959-69
834,834,Jack McMahon,SAC,2,3,80,48,32,160,103,57,198,115,83,0.581,4.0,1.0,3.0,14.0,5.0,9.0,14.0,5.0,9.0,1964,0.25,1959-69
841,841,Alex Hannum,GSW,2,7,80,17,63,160,65,95,502,248,254,0.494,,,,12.0,5.0,7.0,51.0,27.0,24.0,1964,,1959-69
843,843,Richie Guerin,ATL,1,1,47,28,19,47,28,19,47,28,19,0.596,4.0,1.0,3.0,4.0,1.0,3.0,4.0,1.0,3.0,1964,0.25,1959-69
845,845,Red Auerbach,BOS,14,18,80,59,21,1032,679,353,1257,822,435,0.654,10.0,8.0,2.0,119.0,71.0,48.0,139.0,80.0,59.0,1963,0.8,1959-69
846,846,Jack McMahon,SAC,1,2,80,55,25,80,55,25,118,67,51,0.568,10.0,4.0,6.0,10.0,4.0,6.0,10.0,4.0,6.0,1963,0.4,1959-69
851,851,Alex Hannum,GSW,1,6,80,48,32,80,48,32,422,231,191,0.547,12.0,5.0,7.0,12.0,5.0,7.0,51.0,27.0,24.0,1963,0.4166666666666667,1959-69
853,853,Lenny Wilkens,ATL,4,24,82,56,26,328,201,127,1946,1070,876,0.55,10.0,4.0,6.0,34.0,13.0,21.0,144.0,68.0,76.0,1996,0.4,1988-1998
856,856,Phil Jackson,CHI,8,8,82,69,13,656,483,173,656,483,173,0.736,19.0,15.0,4.0,131.0,96.0,35.0,131.0,96.0,35.0,1996,0.7894736842105263,1988-1998
857,857,Mike Fratello,CLE,4,12,82,42,40,328,179,149,905,503,402,0.556,,,,10.0,1.0,9.0,50.0,19.0,31.0,1996,,1988-1998
859,859,Bernie Bickerstaff,DEN,3,8,13,4,9,127,59,68,572,283,289,0.495,,,,3.0,0.0,3.0,33.0,12.0,21.0,1996,,1988-1998
860,860,Dick Motta,DEN,1,25,69,17,52,69,17,52,1952,935,1017,0.479,,,,,,,126.0,56.0,70.0,1996,,1988-1998
861,861,Doug Collins,DET,2,5,82,54,28,164,100,64,410,237,173,0.578,5.0,2.0,3.0,8.0,2.0,6.0,38.0,15.0,23.0,1996,0.4,1988-1998
862,862,Rick Adelman,GSW,2,8,82,30,52,164,66,98,609,357,252,0.586,,,,,,,69.0,36.0,33.0,1996,,1988-1998
863,863,Rudy Tomjanovich,HOU,6,6,82,57,25,440,281,159,440,281,159,0.639,16.0,9.0,7.0,81.0,48.0,33.0,81.0,48.0,33.0,1996,0.5625,1988-1998
864,864,Larry Brown,IND,4,18,82,39,43,328,190,138,1440,853,587,0.5920000000000001,,,,38.0,22.0,16.0,125.0,61.0,64.0,1996,,1988-1998
865,865,Bill Fitch,LAC,3,24,82,36,46,246,82,164,1968,927,1041,0.471,3.0,0.0,3.0,3.0,0.0,3.0,109.0,55.0,54.0,1996,0.0,1988-1998
866,866,Del Harris,LAL,3,12,82,56,26,246,157,89,919,489,430,0.532,9.0,4.0,5.0,23.0,10.0,13.0,75.0,31.0,44.0,1996,0.4444444444444444,1988-1998
867,867,Pat Riley,MIA,2,15,82,61,21,164,103,61,1219,859,360,0.705,17.0,8.0,9.0,20.0,8.0,12.0,232.0,145.0,87.0,1996,0.47058823529411764,1988-1998
868,868,Chris Ford,MIL,1,6,82,33,49,82,33,49,492,255,237,0.518,,,,,,,29.0,13.0,16.0,1996,,1988-1998
869,869,Flip Saunders,MIN,2,2,82,40,42,144,60,84,144,60,84,0.417,3.0,0.0,3.0,3.0,0.0,3.0,3.0,0.0,3.0,1996,0.0,1988-1998
871,871,Jeff Van Gundy,NYK,2,2,82,57,25,105,70,35,105,70,35,0.667,10.0,6.0,4.0,18.0,10.0,8.0,18.0,10.0,8.0,1996,0.6,1988-1998
872,872,Brian Hill,ORL,4,4,49,24,25,295,191,104,295,191,104,0.647,,,,36.0,18.0,18.0,36.0,18.0,18.0,1996,,1988-1998
875,875,Cotton Fitzsimmons,PHO,8,21,8,0,8,549,341,208,1607,832,775,0.518,,,,44.0,22.0,22.0,84.0,35.0,49.0,1996,,1988-1998
877,877,P.J. Carlesimo,POR,3,3,82,49,33,246,137,109,246,137,109,0.557,4.0,1.0,3.0,12.0,3.0,9.0,12.0,3.0,9.0,1996,0.25,1988-1998
879,879,Eddie Jordan,SAC,1,1,15,6,9,15,6,9,15,6,9,0.4,,,,,,,,,,1996,,1988-1998
880,880,Bob Hill,SAS,3,7,18,3,15,182,124,58,469,257,212,0.5479999999999999,,,,25.0,14.0,11.0,37.0,17.0,20.0,1996,,1988-1998
881,881,Gregg Popovich,SAS,1,1,64,17,47,64,17,47,64,17,47,0.266,,,,,,,,,,1996,,1988-1998
882,882,George Karl,OKC,6,10,82,57,25,452,323,129,747,442,305,0.5920000000000001,12.0,6.0,6.0,70.0,36.0,34.0,84.0,41.0,43.0,1996,0.5,1988-1998
884,884,Jerry Sloan,UTA,9,12,82,64,18,721,483,238,936,577,359,0.616,20.0,13.0,7.0,97.0,50.0,47.0,103.0,52.0,51.0,1996,0.65,1988-1998
887,887,Jim Lynam,WAS,3,10,46,22,24,210,82,128,720,328,392,0.456,,,,,,,21.0,8.0,13.0,1996,,1988-1998
889,889,Bernie Bickerstaff,WAS,1,8,35,22,13,35,22,13,572,283,289,0.495,3.0,0.0,3.0,3.0,0.0,3.0,33.0,12.0,21.0,1996,0.0,1988-1998
890,890,Gene Shue,WAS,2,2,82,36,46,138,52,86,138,52,86,0.377,,,,,,,,,,1967,,1959-69
891,891,Bill Russell,BOS,2,2,82,54,28,163,114,49,163,114,49,0.6990000000000001,19.0,12.0,7.0,28.0,16.0,12.0,28.0,16.0,12.0,1967,0.631578947368421,1959-69
895,895,Butch van Breda Kolff,LAL,1,1,82,52,30,82,52,30,82,52,30,0.634,15.0,10.0,5.0,15.0,10.0,5.0,15.0,10.0,5.0,1967,0.6666666666666666,1959-69
897,897,Red Holzman,NYK,1,5,44,28,16,44,28,16,247,111,136,0.449,6.0,2.0,4.0,6.0,2.0,4.0,14.0,6.0,8.0,1967,0.3333333333333333,1959-69
898,898,Alex Hannum,PHI,5,10,82,62,20,402,257,145,745,413,332,0.5539999999999999,13.0,7.0,6.0,46.0,26.0,20.0,79.0,45.0,34.0,1967,0.5384615384615384,1959-69
899,899,Jack McMahon,HOU,1,6,82,15,67,82,15,67,441,214,227,0.485,,,,,,,23.0,8.0,15.0,1967,,1959-69
902,902,Richie Guerin,ATL,4,4,82,56,26,290,159,131,290,159,131,0.5479999999999999,6.0,2.0,4.0,29.0,14.0,15.0,29.0,14.0,15.0,1967,0.3333333333333333,1959-69
903,903,Cotton Fitzsimmons,ATL,3,5,82,31,51,246,112,134,410,209,201,0.51,,,,6.0,2.0,4.0,6.0,2.0,4.0,1974,,1969-1979
904,904,Tom Heinsohn,BOS,6,6,82,60,22,492,318,174,492,318,174,0.6459999999999999,11.0,6.0,5.0,53.0,30.0,23.0,53.0,30.0,23.0,1974,0.5454545454545454,1969-1979
905,905,Jack Ramsay,LAC,3,7,82,49,33,246,112,134,574,286,288,0.498,7.0,3.0,4.0,13.0,5.0,8.0,30.0,10.0,20.0,1974,0.42857142857142855,1969-1979
906,906,Dick Motta,CHI,7,7,82,47,35,574,332,242,574,332,242,0.578,13.0,7.0,6.0,47.0,18.0,29.0,47.0,18.0,29.0,1974,0.5384615384615384,1969-1979
907,907,Bill Fitch,CLE,5,5,82,40,42,410,139,271,410,139,271,0.339,,,,,,,,,,1974,,1969-1979
909,909,Al Attles,GSW,6,6,82,48,34,440,239,201,440,239,201,0.5429999999999999,17.0,12.0,5.0,38.0,19.0,19.0,38.0,19.0,19.0,1974,0.7058823529411765,1969-1979
911,911,Phil Johnson,SAC,2,2,82,44,38,140,71,69,140,71,69,0.507,6.0,2.0,4.0,6.0,2.0,4.0,6.0,2.0,4.0,1974,0.3333333333333333,1969-1979
913,913,Larry Costello,MIL,7,7,82,38,44,574,369,205,574,369,205,0.643,,,,57.0,36.0,21.0,57.0,36.0,21.0,1974,,1969-1979
916,916,Butch van Breda Kolff,UTA,1,8,66,22,44,66,22,44,495,235,260,0.475,,,,,,,33.0,21.0,12.0,1974,,1969-1979
917,917,Red Holzman,NYK,8,12,82,40,42,618,388,230,821,471,350,0.574,3.0,1.0,2.0,95.0,54.0,41.0,103.0,58.0,45.0,1974,0.3333333333333333,1969-1979
918,918,Gene Shue,PHI,2,9,82,34,48,164,59,105,712,350,362,0.4920000000000001,,,,,,,40.0,14.0,26.0,1974,,1969-1979
919,919,John MacLeod,PHO,2,2,82,32,50,164,62,102,164,62,102,0.378,,,,,,,,,,1974,,1969-1979
920,920,Lenny Wilkens,POR,1,4,82,38,44,82,38,44,328,159,169,0.485,,,,,,,,,,1974,,1969-1979
921,921,Bill Russell,OKC,2,5,82,43,39,164,79,85,409,241,168,0.589,9.0,4.0,5.0,9.0,4.0,5.0,55.0,32.0,23.0,1974,0.4444444444444444,1969-1979
922,922,K.C. Jones,WAS,2,3,82,60,22,164,107,57,248,137,111,0.552,17.0,8.0,9.0,24.0,11.0,13.0,28.0,11.0,17.0,1974,0.47058823529411764,1969-1979
924,924,Chris Ford,BOS,1,1,82,56,26,82,56,26,82,56,26,0.6829999999999999,11.0,5.0,6.0,11.0,5.0,6.0,11.0,5.0,6.0,1990,0.45454545454545453,1988-1998
926,926,Phil Jackson,CHI,2,2,82,61,21,164,116,48,164,116,48,0.7070000000000001,17.0,15.0,2.0,33.0,25.0,8.0,33.0,25.0,8.0,1990,0.8823529411764706,1988-1998
927,927,Lenny Wilkens,CLE,5,18,82,33,49,410,205,205,1454,758,696,0.521,,,,15.0,6.0,9.0,84.0,43.0,41.0,1990,,1988-1998
930,930,Chuck Daly,DET,8,9,82,50,32,656,419,237,697,428,269,0.614,15.0,7.0,8.0,108.0,69.0,39.0,108.0,69.0,39.0,1990,0.4666666666666667,1988-1998
931,931,Don Nelson,GSW,3,14,82,44,38,246,124,122,1130,664,466,0.588,9.0,4.0,5.0,17.0,8.0,9.0,105.0,50.0,55.0,1990,0.4444444444444444,1988-1998
932,932,Don Chaney,HOU,3,6,82,52,30,246,138,108,431,191,240,0.443,3.0,0.0,3.0,11.0,2.0,9.0,11.0,2.0,9.0,1990,0.0,1988-1998
934,934,Bob Hill,IND,1,2,57,32,25,57,32,25,123,52,71,0.423,5.0,2.0,3.0,5.0,2.0,3.0,5.0,2.0,3.0,1990,0.4,1988-1998
936,936,Mike Dunleavy,LAL,1,1,82,58,24,82,58,24,82,58,24,0.7070000000000001,19.0,12.0,7.0,19.0,12.0,7.0,19.0,12.0,7.0,1990,0.631578947368421,1988-1998
938,938,Del Harris,MIL,4,8,82,48,34,328,183,145,656,324,332,0.494,3.0,0.0,3.0,21.0,6.0,15.0,52.0,21.0,31.0,1990,0.0,1988-1998
940,940,Bill Fitch,BRK,2,20,82,26,56,164,43,121,1640,805,835,0.491,,,,,,,102.0,54.0,48.0,1990,,1988-1998
942,942,John MacLeod,NYK,1,18,67,32,35,67,32,35,1364,707,657,0.518,3.0,0.0,3.0,3.0,0.0,3.0,101.0,47.0,54.0,1990,0.0,1988-1998
944,944,Jim Lynam,PHI,4,6,82,44,38,285,159,126,428,211,217,0.493,8.0,4.0,4.0,21.0,8.0,13.0,21.0,8.0,13.0,1990,0.5,1988-1998
945,945,Cotton Fitzsimmons,PHO,5,18,82,55,27,410,261,149,1468,752,716,0.512,4.0,1.0,3.0,32.0,17.0,15.0,72.0,30.0,42.0,1990,0.25,1988-1998
946,946,Rick Adelman,POR,3,3,82,63,19,199,136,63,199,136,63,0.6829999999999999,16.0,9.0,7.0,40.0,21.0,19.0,40.0,21.0,19.0,1990,0.5625,1988-1998
947,947,Dick Motta,SAC,2,21,82,25,57,136,41,95,1694,849,845,0.501,,,,,,,126.0,56.0,70.0,1990,,1988-1998
948,948,Larry Brown,SAS,3,12,82,55,27,246,132,114,957,578,379,0.604,4.0,1.0,3.0,14.0,7.0,7.0,77.0,35.0,42.0,1990,0.25,1988-1998
949,949,K.C. Jones,OKC,1,10,82,41,41,82,41,41,822,534,288,0.65,5.0,2.0,3.0,5.0,2.0,3.0,142.0,81.0,61.0,1990,0.4,1988-1998
950,950,Jerry Sloan,UTA,3,6,82,54,28,229,149,80,444,243,201,0.547,9.0,4.0,5.0,17.0,6.0,11.0,23.0,8.0,15.0,1990,0.4444444444444444,1988-1998
958,958,Rick Carlisle,DAL,10,16,82,24,58,804,437,367,1296,718,578,0.5539999999999999,,,,58.0,28.0,30.0,120.0,58.0,62.0,2017,,2008-2018
960,960,Stan Van Gundy,DET,4,12,82,39,43,328,152,176,907,523,384,0.5770000000000001,,,,4.0,0.0,4.0,91.0,48.0,43.0,2017,,2008-2018
962,962,Mike D'Antoni,HOU,2,14,82,65,17,164,120,44,1045,575,470,0.55,17.0,11.0,6.0,28.0,17.0,11.0,87.0,43.0,44.0,2017,0.6470588235294118,2008-2018
963,963,Nate McMillan,IND,2,14,82,48,34,164,90,74,1094,568,526,0.519,7.0,3.0,4.0,11.0,3.0,8.0,45.0,17.0,28.0,2017,0.42857142857142855,2008-2018
964,964,Doc Rivers,LAC,5,19,82,42,40,410,259,151,1470,846,624,0.5760000000000001,,,,40.0,18.0,22.0,161.0,82.0,79.0,2017,,2008-2018
968,968,Erik Spoelstra,MIA,10,10,82,44,38,804,484,320,804,484,320,0.602,5.0,1.0,4.0,118.0,71.0,47.0,118.0,71.0,47.0,2017,0.2,2008-2018
971,971,Tom Thibodeau,MIN,2,7,82,47,35,164,78,86,558,333,225,0.597,5.0,1.0,4.0,5.0,1.0,4.0,56.0,24.0,32.0,2017,0.2,2008-2018
972,972,Alvin Gentry,NOP,3,15,82,48,34,246,112,134,951,447,504,0.47,9.0,5.0,4.0,9.0,5.0,4.0,30.0,17.0,13.0,2017,0.5555555555555556,2008-2018
975,975,Frank Vogel,ORL,2,8,82,25,57,164,54,110,595,304,291,0.511,,,,,,,61.0,31.0,30.0,2017,,2008-2018
979,979,Terry Stotts,POR,6,10,82,49,33,492,272,220,775,387,388,0.499,4.0,0.0,4.0,35.0,11.0,24.0,40.0,12.0,28.0,2017,0.0,2008-2018
981,981,Gregg Popovich,SAS,22,22,82,47,35,1738,1197,541,1738,1197,541,0.6890000000000001,5.0,1.0,4.0,277.0,167.0,110.0,277.0,167.0,110.0,2017,0.2,2008-2018
982,982,Dwane Casey,TOR,7,9,82,59,23,558,320,238,680,373,307,0.5489999999999999,10.0,4.0,6.0,51.0,21.0,30.0,51.0,21.0,30.0,2017,0.4,2008-2018
984,984,Scott Brooks,WAS,2,9,82,43,39,164,92,72,709,430,279,0.606,6.0,2.0,4.0,19.0,9.0,10.0,92.0,48.0,44.0,2017,0.3333333333333333,2008-2018
986,986,Doc Rivers,BOS,7,12,82,56,26,574,336,238,913,507,406,0.555,9.0,5.0,4.0,80.0,46.0,34.0,95.0,51.0,44.0,2010,0.5555555555555556,2008-2018
987,987,Larry Brown,CHO,3,30,28,9,19,192,88,104,2338,1327,1011,0.568,,,,4.0,0.0,4.0,235.0,120.0,115.0,2010,,2008-2018
988,988,Paul Silas,CHO,5,11,54,25,29,335,186,149,809,380,429,0.47,,,,23.0,11.0,12.0,29.0,13.0,16.0,2010,,2008-2018
989,989,Tom Thibodeau,CHI,1,1,82,62,20,82,62,20,82,62,20,0.7559999999999999,16.0,9.0,7.0,16.0,9.0,7.0,16.0,9.0,7.0,2010,0.5625,2008-2018
990,990,Byron Scott,CLE,1,11,82,19,63,82,19,63,789,371,418,0.47,,,,,,,57.0,33.0,24.0,2010,,2008-2018
991,991,Rick Carlisle,DAL,3,9,82,57,25,246,162,84,738,443,295,0.6,21.0,16.0,5.0,37.0,23.0,14.0,99.0,53.0,46.0,2010,0.7619047619047619,2008-2018
992,992,George Karl,DEN,7,23,82,50,32,532,328,204,1739,1036,703,0.596,5.0,1.0,4.0,46.0,16.0,30.0,172.0,75.0,97.0,2010,0.2,2008-2018
995,995,Rick Adelman,HOU,4,20,82,43,39,328,193,135,1561,945,616,0.605,,,,19.0,9.0,10.0,157.0,79.0,78.0,2010,,2008-2018
996,996,Jim O'Brien,IND,4,9,44,17,27,290,121,169,630,303,327,0.481,,,,,,,31.0,14.0,17.0,2010,,2008-2018
997,997,Frank Vogel,IND,1,1,38,20,18,38,20,18,38,20,18,0.526,5.0,1.0,4.0,5.0,1.0,4.0,5.0,1.0,4.0,2010,0.2,2008-2018
999,999,Phil Jackson,LAL,11,20,82,57,25,902,610,292,1640,1155,485,0.7040000000000001,10.0,4.0,6.0,181.0,118.0,63.0,333.0,229.0,104.0,2010,0.4,2008-2018
1000,1000,Lionel Hollins,MEM,5,5,82,46,36,267,117,150,267,117,150,0.438,13.0,7.0,6.0,13.0,7.0,6.0,13.0,7.0,6.0,2010,0.5384615384615384,2008-2018
1001,1001,Erik Spoelstra,MIA,3,3,82,58,24,246,148,98,246,148,98,0.602,21.0,14.0,7.0,33.0,18.0,15.0,33.0,18.0,15.0,2010,0.6666666666666666,2008-2018
1002,1002,Scott Skiles,MIL,3,11,82,35,47,246,115,131,778,396,382,0.509,,,,7.0,3.0,4.0,42.0,18.0,24.0,2010,,2008-2018
1006,1006,Mike D'Antoni,NYK,3,9,82,42,40,246,103,143,685,370,315,0.54,4.0,0.0,4.0,4.0,0.0,4.0,55.0,26.0,29.0,2010,0.0,2008-2018
1007,1007,Scott Brooks,OKC,3,3,82,55,27,233,127,106,233,127,106,0.545,17.0,9.0,8.0,23.0,11.0,12.0,23.0,11.0,12.0,2010,0.5294117647058824,2008-2018
1008,1008,Stan Van Gundy,ORL,4,7,82,52,30,328,222,106,513,334,179,0.6509999999999999,6.0,2.0,4.0,54.0,30.0,24.0,82.0,47.0,35.0,2010,0.3333333333333333,2008-2018
1009,1009,Doug Collins,PHI,1,9,82,41,41,82,41,41,701,373,328,0.532,5.0,1.0,4.0,5.0,1.0,4.0,43.0,16.0,27.0,2010,0.2,2008-2018
1010,1010,Alvin Gentry,PHO,3,10,82,40,42,195,112,83,598,289,309,0.483,,,,16.0,10.0,6.0,21.0,12.0,9.0,2010,,2008-2018
1011,1011,Nate McMillan,POR,6,11,82,48,34,492,246,246,887,458,429,0.516,6.0,2.0,4.0,18.0,6.0,12.0,34.0,14.0,20.0,2010,0.3333333333333333,2008-2018
1012,1012,Paul Westphal,SAC,2,9,82,24,58,164,49,115,590,316,274,0.536,,,,,,,49.0,27.0,22.0,2010,,2008-2018
1013,1013,Gregg Popovich,SAS,15,15,82,61,21,1180,797,383,1180,797,383,0.675,6.0,2.0,4.0,181.0,108.0,73.0,181.0,108.0,73.0,2010,0.3333333333333333,2008-2018
1015,1015,Jerry Sloan,UTA,23,26,54,31,23,1809,1127,682,2024,1221,803,0.603,,,,196.0,96.0,100.0,202.0,98.0,104.0,2010,,2008-2018
1017,1017,Flip Saunders,WAS,2,15,82,23,59,164,49,115,1147,636,511,0.5539999999999999,,,,,,,98.0,47.0,51.0,2010,,2008-2018
1018,1018,Mike Woodson,ATL,5,5,82,47,35,410,153,257,410,153,257,0.373,11.0,4.0,7.0,18.0,7.0,11.0,18.0,7.0,11.0,2008,0.36363636363636365,1998-2008
1019,1019,Doc Rivers,BOS,5,10,82,62,20,410,230,180,749,401,348,0.535,14.0,7.0,7.0,47.0,26.0,21.0,62.0,31.0,31.0,2008,0.5,1998-2008
1020,1020,Larry Brown,CHO,1,28,82,35,47,82,35,47,2228,1274,954,0.5720000000000001,,,,,,,231.0,120.0,111.0,2008,,1998-2008
1022,1022,Mike Brown,CLE,4,4,82,66,16,328,211,117,328,211,117,0.643,14.0,10.0,4.0,60.0,36.0,24.0,60.0,36.0,24.0,2008,0.7142857142857143,1998-2008
1023,1023,Rick Carlisle,DAL,1,7,82,50,32,82,50,32,574,331,243,0.5770000000000001,10.0,5.0,5.0,10.0,5.0,5.0,72.0,35.0,37.0,2008,0.5,1998-2008
1024,1024,George Karl,DEN,5,21,82,54,28,368,225,143,1575,933,642,0.5920000000000001,16.0,10.0,6.0,35.0,13.0,22.0,161.0,72.0,89.0,2008,0.625,1998-2008
1026,1026,Don Nelson,GSW,10,30,82,29,53,783,396,387,2316,1309,1007,0.565,,,,35.0,14.0,21.0,166.0,75.0,91.0,2008,,1998-2008
1027,1027,Rick Adelman,HOU,2,18,82,53,29,164,108,56,1397,860,537,0.616,13.0,7.0,6.0,19.0,9.0,10.0,157.0,79.0,78.0,2008,0.5384615384615384,1998-2008
1028,1028,Jim O'Brien,IND,2,7,82,36,46,164,72,92,504,254,250,0.504,,,,,,,31.0,14.0,17.0,2008,,1998-2008
1029,1029,Mike Dunleavy,LAC,6,16,82,19,63,492,194,298,1280,592,688,0.463,,,,12.0,7.0,5.0,71.0,38.0,33.0,2008,,1998-2008
1030,1030,Phil Jackson,LAL,9,18,82,65,17,738,496,242,1476,1041,435,0.705,23.0,16.0,7.0,148.0,98.0,50.0,300.0,209.0,91.0,2008,0.6956521739130435,1998-2008
1033,1033,Lionel Hollins,MEM,3,3,39,13,26,103,31,72,103,31,72,0.301,,,,,,,,,,2008,,1998-2008
1034,1034,Erik Spoelstra,MIA,1,1,82,43,39,82,43,39,82,43,39,0.524,7.0,3.0,4.0,7.0,3.0,4.0,7.0,3.0,4.0,2008,0.42857142857142855,1998-2008
1035,1035,Scott Skiles,MIL,1,9,82,34,48,82,34,48,614,315,299,0.513,,,,,,,35.0,15.0,20.0,2008,,1998-2008
1036,1036,Randy Wittman,MIN,3,5,19,4,15,143,38,105,307,100,207,0.326,,,,,,,,,,2008,,1998-2008
1038,1038,Lawrence Frank,BRK,6,6,82,34,48,450,225,225,450,225,225,0.5,,,,38.0,18.0,20.0,38.0,18.0,20.0,2008,,1998-2008
1039,1039,Byron Scott,NOP,5,9,82,49,33,410,200,210,698,349,349,0.5,5.0,1.0,4.0,17.0,8.0,9.0,57.0,33.0,24.0,2008,0.2,1998-2008
1040,1040,Mike D'Antoni,NYK,1,7,82,32,50,82,32,50,521,299,222,0.574,,,,,,,51.0,26.0,25.0,2008,,1998-2008
1041,1041,P.J. Carlesimo,OKC,2,8,13,1,12,95,21,74,500,204,296,0.408,,,,,,,12.0,3.0,9.0,2008,,1998-2008
1042,1042,Scott Brooks,OKC,1,1,69,22,47,69,22,47,69,22,47,0.319,,,,,,,,,,2008,,1998-2008
1043,1043,Stan Van Gundy,ORL,2,5,82,59,23,164,111,53,349,223,126,0.639,24.0,13.0,11.0,34.0,18.0,16.0,62.0,35.0,27.0,2008,0.5416666666666666,1998-2008
1044,1044,Maurice Cheeks,PHI,4,8,23,9,14,269,122,147,570,284,286,0.498,,,,6.0,2.0,4.0,16.0,5.0,11.0,2008,,1998-2008
1047,1047,Alvin Gentry,PHO,1,8,31,18,13,31,18,13,434,195,239,0.449,,,,,,,5.0,2.0,3.0,2008,,1998-2008
1048,1048,Nate McMillan,POR,4,9,82,54,28,328,148,180,723,360,363,0.498,6.0,2.0,4.0,6.0,2.0,4.0,22.0,10.0,12.0,2008,0.3333333333333333,1998-2008
1051,1051,Gregg Popovich,SAS,13,13,82,54,28,1016,686,330,1016,686,330,0.675,5.0,1.0,4.0,165.0,102.0,63.0,165.0,102.0,63.0,2008,0.2,1998-2008
1054,1054,Jerry Sloan,UTA,21,24,82,48,34,1673,1043,630,1888,1137,751,0.602,5.0,1.0,4.0,186.0,92.0,94.0,192.0,94.0,98.0,2008,0.2,1998-2008
1055,1055,Eddie Jordan,WAS,6,8,11,1,10,421,197,224,518,230,288,0.444,,,,26.0,8.0,18.0,26.0,8.0,18.0,2008,,1998-2008
1059,1059,Gene Shue,WAS,1,1,56,16,40,56,16,40,56,16,40,0.28600000000000003,,,,,,,,,,1966,,1959-69
1060,1060,Bill Russell,BOS,1,1,81,60,21,81,60,21,81,60,21,0.741,9.0,4.0,5.0,9.0,4.0,5.0,9.0,4.0,5.0,1966,0.4444444444444444,1959-69
1062,1062,Jack McMahon,SAC,4,5,81,39,42,321,187,134,359,199,160,0.5539999999999999,4.0,1.0,3.0,23.0,8.0,15.0,23.0,8.0,15.0,1966,0.25,1959-69
1067,1067,Alex Hannum,PHI,4,9,81,68,13,320,195,125,663,351,312,0.529,15.0,11.0,4.0,33.0,19.0,14.0,66.0,38.0,28.0,1966,0.7333333333333333,1959-69
1069,1069,Richie Guerin,ATL,3,3,81,39,42,208,103,105,208,103,105,0.495,9.0,5.0,4.0,23.0,12.0,11.0,23.0,12.0,11.0,1966,0.5555555555555556,1959-69
1070,1070,Lenny Wilkens,ATL,2,22,82,42,40,164,99,65,1782,968,814,0.5429999999999999,3.0,0.0,3.0,14.0,5.0,9.0,124.0,60.0,64.0,1994,0.0,1988-1998
1071,1071,Chris Ford,BOS,5,5,82,35,47,410,222,188,410,222,188,0.541,4.0,1.0,3.0,29.0,13.0,16.0,29.0,13.0,16.0,1994,0.25,1988-1998
1073,1073,Phil Jackson,CHI,6,6,82,47,35,492,342,150,492,342,150,0.695,10.0,5.0,5.0,94.0,66.0,28.0,94.0,66.0,28.0,1994,0.5,1988-1998
1074,1074,Mike Fratello,CLE,2,10,82,43,39,164,90,74,741,414,327,0.5589999999999999,4.0,1.0,3.0,7.0,1.0,6.0,47.0,19.0,28.0,1994,0.25,1988-1998
1075,1075,Dick Motta,DAL,8,23,82,36,46,656,303,353,1801,892,909,0.495,,,,28.0,11.0,17.0,126.0,56.0,70.0,1994,,1988-1998
1078,1078,Bernie Bickerstaff,DEN,1,6,32,20,12,32,20,12,442,222,220,0.502,3.0,0.0,3.0,3.0,0.0,3.0,30.0,12.0,18.0,1994,0.0,1988-1998
1079,1079,Don Chaney,DET,2,9,82,28,54,164,48,116,647,265,382,0.41,,,,,,,11.0,2.0,9.0,1994,,1988-1998
1080,1080,Don Nelson,GSW,7,18,45,14,31,537,277,260,1421,817,604,0.575,,,,24.0,9.0,15.0,112.0,51.0,61.0,1994,,1988-1998
1082,1082,Rudy Tomjanovich,HOU,4,4,82,47,35,276,176,100,276,176,100,0.638,22.0,15.0,7.0,57.0,36.0,21.0,57.0,36.0,21.0,1994,0.6818181818181818,1988-1998
1083,1083,Larry Brown,IND,2,16,82,52,30,164,99,65,1276,762,514,0.597,17.0,10.0,7.0,33.0,20.0,13.0,120.0,59.0,61.0,1994,0.5882352941176471,1988-1998
1084,1084,Bill Fitch,LAC,1,22,82,17,65,82,17,65,1804,862,942,0.478,,,,,,,106.0,55.0,51.0,1994,,1988-1998
1085,1085,Del Harris,LAL,1,10,82,48,34,82,48,34,755,380,375,0.503,10.0,5.0,5.0,10.0,5.0,5.0,62.0,26.0,36.0,1994,0.5,1988-1998
1086,1086,Kevin Loughery,MIA,4,20,46,17,29,292,133,159,1388,642,746,0.463,,,,8.0,2.0,6.0,59.0,27.0,32.0,1994,,1988-1998
1087,1087,Alvin Gentry,MIA,1,1,36,15,21,36,15,21,36,15,21,0.417,,,,,,,,,,1994,,1988-1998
1088,1088,Mike Dunleavy,MIL,3,5,82,34,48,246,82,164,410,183,227,0.446,,,,,,,23.0,13.0,10.0,1994,,1988-1998
1091,1091,Pat Riley,NYK,4,13,82,55,27,328,223,105,1055,756,299,0.7170000000000001,11.0,6.0,5.0,63.0,35.0,28.0,212.0,137.0,75.0,1994,0.5454545454545454,1988-1998
1092,1092,Brian Hill,ORL,2,2,82,57,25,164,107,57,164,107,57,0.652,21.0,11.0,10.0,24.0,11.0,13.0,24.0,11.0,13.0,1994,0.5238095238095238,1988-1998
1094,1094,Paul Westphal,PHO,3,3,82,59,23,246,177,69,246,177,69,0.72,10.0,6.0,4.0,44.0,25.0,19.0,44.0,25.0,19.0,1994,0.6,1988-1998
1095,1095,P.J. Carlesimo,POR,1,1,82,44,38,82,44,38,82,44,38,0.537,3.0,0.0,3.0,3.0,0.0,3.0,3.0,0.0,3.0,1994,0.0,1988-1998
1097,1097,Bob Hill,SAS,1,5,82,62,20,82,62,20,369,195,174,0.528,15.0,9.0,6.0,15.0,9.0,6.0,27.0,12.0,15.0,1994,0.6,1988-1998
1098,1098,George Karl,OKC,4,8,82,57,25,288,202,86,583,321,262,0.551,4.0,1.0,3.0,37.0,17.0,20.0,51.0,22.0,29.0,1994,0.25,1988-1998
1099,1099,Jerry Sloan,UTA,7,10,82,60,22,557,364,193,772,458,314,0.593,5.0,2.0,3.0,59.0,27.0,32.0,65.0,29.0,36.0,1994,0.4,1988-1998
1100,1100,Jim Lynam,WAS,1,8,82,21,61,82,21,61,592,267,325,0.451,,,,,,,21.0,8.0,13.0,1994,,1988-1998
1101,1101,Mike Woodson,ATL,3,3,82,30,52,246,69,177,246,69,177,0.28,,,,,,,,,,2006,,1998-2008
1102,1102,Doc Rivers,BOS,3,8,82,24,58,246,102,144,585,273,312,0.467,,,,7.0,3.0,4.0,22.0,8.0,14.0,2006,,1998-2008
1103,1103,Bernie Bickerstaff,CHO,3,13,82,33,49,246,77,169,932,415,517,0.445,,,,,,,33.0,12.0,21.0,2006,,1998-2008
1104,1104,Scott Skiles,CHI,4,7,82,49,33,312,156,156,507,272,235,0.536,10.0,6.0,4.0,22.0,10.0,12.0,35.0,15.0,20.0,2006,0.6,1998-2008
1105,1105,Mike Brown,CLE,2,2,82,50,32,164,100,64,164,100,64,0.61,20.0,12.0,8.0,33.0,19.0,14.0,33.0,19.0,14.0,2006,0.6,1998-2008
1107,1107,George Karl,DEN,3,19,82,45,37,204,121,83,1411,829,582,0.588,5.0,1.0,4.0,15.0,3.0,12.0,141.0,62.0,79.0,2006,0.2,1998-2008
1108,1108,Flip Saunders,DET,2,12,82,53,29,164,117,47,901,528,373,0.586,16.0,10.0,6.0,34.0,20.0,14.0,81.0,37.0,44.0,2006,0.625,1998-2008
1109,1109,Don Nelson,GSW,8,28,82,42,40,619,319,300,2152,1232,920,0.5720000000000001,11.0,5.0,6.0,35.0,14.0,21.0,166.0,75.0,91.0,2006,0.45454545454545453,1998-2008
1110,1110,Jeff Van Gundy,HOU,4,11,82,52,30,328,182,146,748,430,318,0.575,7.0,3.0,4.0,19.0,7.0,12.0,88.0,44.0,44.0,2006,0.42857142857142855,1998-2008
1111,1111,Rick Carlisle,IND,4,6,82,35,47,328,181,147,492,281,211,0.5710000000000001,,,,35.0,18.0,17.0,62.0,30.0,32.0,2006,,1998-2008
1112,1112,Mike Dunleavy,LAC,4,14,82,40,42,328,152,176,1116,550,566,0.493,,,,12.0,7.0,5.0,71.0,38.0,33.0,2006,,1998-2008
1113,1113,Phil Jackson,LAL,7,16,82,42,40,574,374,200,1312,919,393,0.7,5.0,1.0,4.0,104.0,68.0,36.0,256.0,179.0,77.0,2006,0.2,1998-2008
1114,1114,Mike Fratello,MEM,3,17,30,6,24,178,95,83,1215,667,548,0.5489999999999999,,,,8.0,0.0,8.0,62.0,20.0,42.0,2006,,1998-2008
1116,1116,Pat Riley,MIA,10,23,82,44,38,767,439,328,1822,1195,627,0.6559999999999999,4.0,0.0,4.0,70.0,34.0,36.0,282.0,171.0,111.0,2006,0.0,1998-2008
1117,1117,Terry Stotts,MIL,2,4,64,23,41,146,63,83,283,115,168,0.406,,,,5.0,1.0,4.0,5.0,1.0,4.0,2006,,1998-2008
1119,1119,Dwane Casey,MIN,2,2,40,20,20,122,53,69,122,53,69,0.434,,,,,,,,,,2006,,1998-2008
1120,1120,Randy Wittman,MIN,1,3,42,12,30,42,12,30,206,74,132,0.359,,,,,,,,,,2006,,1998-2008
1121,1121,Lawrence Frank,BRK,4,4,82,41,41,286,157,129,286,157,129,0.5489999999999999,12.0,6.0,6.0,38.0,18.0,20.0,38.0,18.0,20.0,2006,0.5,1998-2008
1122,1122,Byron Scott,NOP,3,7,82,39,43,246,95,151,534,244,290,0.457,,,,,,,40.0,25.0,15.0,2006,,1998-2008
1124,1124,Brian Hill,ORL,6,9,82,40,42,459,267,192,613,298,315,0.486,4.0,0.0,4.0,40.0,18.0,22.0,40.0,18.0,22.0,2006,0.0,1998-2008
1125,1125,Maurice Cheeks,PHI,2,6,82,35,47,164,73,91,465,235,230,0.505,,,,,,,10.0,3.0,7.0,2006,,1998-2008
1126,1126,Mike D'Antoni,PHO,4,5,82,61,21,307,198,109,357,212,145,0.594,11.0,6.0,5.0,46.0,25.0,21.0,46.0,25.0,21.0,2006,0.5454545454545454,1998-2008
1127,1127,Nate McMillan,POR,2,7,82,32,50,164,53,111,559,265,294,0.474,,,,,,,16.0,8.0,8.0,2006,,1998-2008
1129,1129,Gregg Popovich,SAS,11,11,82,58,24,852,576,276,852,576,276,0.6759999999999999,20.0,16.0,4.0,143.0,92.0,51.0,143.0,92.0,51.0,2006,0.8,1998-2008
1130,1130,Bob Hill,OKC,2,9,82,31,51,134,53,81,603,310,293,0.514,,,,,,,37.0,17.0,20.0,2006,,1998-2008
1132,1132,Jerry Sloan,UTA,19,22,82,51,31,1509,941,568,1724,1035,689,0.6,17.0,9.0,8.0,169.0,85.0,84.0,175.0,87.0,88.0,2006,0.5294117647058824,1998-2008
1133,1133,Eddie Jordan,WAS,4,6,82,41,41,328,153,175,425,186,239,0.438,4.0,0.0,4.0,20.0,6.0,14.0,20.0,6.0,14.0,2006,0.0,1998-2008
1134,1134,Richie Guerin,ATL,8,8,82,36,46,618,327,291,618,327,291,0.529,6.0,2.0,4.0,60.0,26.0,34.0,60.0,26.0,34.0,1971,0.3333333333333333,1969-1979
1135,1135,Gene Shue,WAS,6,6,82,38,44,466,239,227,466,239,227,0.513,6.0,2.0,4.0,35.0,13.0,22.0,35.0,13.0,22.0,1971,0.3333333333333333,1969-1979
1136,1136,Tom Heinsohn,BOS,3,3,82,56,26,246,134,112,246,134,112,0.545,11.0,5.0,6.0,11.0,5.0,6.0,11.0,5.0,6.0,1971,0.45454545454545453,1969-1979
1139,1139,Dick Motta,CHI,4,4,82,57,25,328,180,148,328,180,148,0.5489999999999999,4.0,0.0,4.0,16.0,4.0,12.0,16.0,4.0,12.0,1971,0.0,1969-1979
1141,1141,Bill Fitch,CLE,2,2,82,23,59,164,38,126,164,38,126,0.232,,,,,,,,,,1971,,1969-1979
1142,1142,Butch van Breda Kolff,DET,3,5,10,6,4,174,82,92,338,189,149,0.5589999999999999,,,,,,,33.0,21.0,12.0,1971,,1969-1979
1145,1145,Al Attles,GSW,3,3,82,51,31,194,100,94,194,100,94,0.515,5.0,1.0,4.0,10.0,2.0,8.0,10.0,2.0,8.0,1971,0.2,1969-1979
1148,1148,Larry Costello,MIL,4,4,82,63,19,328,212,116,328,212,116,0.6459999999999999,11.0,6.0,5.0,35.0,23.0,12.0,35.0,23.0,12.0,1971,0.5454545454545454,1969-1979
1149,1149,Red Holzman,NYK,5,9,82,48,34,372,242,130,575,325,250,0.565,16.0,9.0,7.0,63.0,36.0,27.0,71.0,40.0,31.0,1971,0.5625,1969-1979
1150,1150,Jack Ramsay,PHI,4,4,82,30,52,328,174,154,328,174,154,0.53,,,,17.0,5.0,12.0,17.0,5.0,12.0,1971,,1969-1979
1151,1151,Cotton Fitzsimmons,PHO,2,2,82,49,33,164,97,67,164,97,67,0.591,,,,,,,,,,1971,,1969-1979
1154,1154,Lenny Wilkens,OKC,3,3,82,47,35,246,121,125,246,121,125,0.4920000000000001,,,,,,,,,,1971,,1969-1979
1159,1159,Tom Thibodeau,CHI,4,4,82,48,34,312,205,107,312,205,107,0.657,5.0,1.0,4.0,39.0,17.0,22.0,39.0,17.0,22.0,2013,0.2,2008-2018
1160,1160,Mike Brown,CLE,6,8,82,33,49,492,305,187,563,347,216,0.616,,,,71.0,42.0,29.0,83.0,47.0,36.0,2013,,2008-2018
1161,1161,Rick Carlisle,DAL,6,12,82,49,33,476,288,188,968,569,399,0.588,7.0,3.0,4.0,48.0,26.0,22.0,110.0,56.0,54.0,2013,0.42857142857142855,2008-2018
1163,1163,Maurice Cheeks,DET,1,9,50,21,29,50,21,29,620,305,315,0.4920000000000001,,,,,,,16.0,5.0,11.0,2013,,2008-2018
1167,1167,Frank Vogel,IND,4,4,82,56,26,267,167,100,267,167,100,0.625,19.0,10.0,9.0,54.0,28.0,26.0,54.0,28.0,26.0,2013,0.5263157894736842,2008-2018
1168,1168,Doc Rivers,LAC,1,15,82,57,25,82,57,25,1142,644,498,0.564,13.0,6.0,7.0,13.0,6.0,7.0,134.0,70.0,64.0,2013,0.46153846153846156,2008-2018
1169,1169,Mike D'Antoni,LAL,2,12,82,27,55,154,67,87,881,455,426,0.516,,,,4.0,0.0,4.0,59.0,26.0,33.0,2013,,2008-2018
1171,1171,Erik Spoelstra,MIA,6,6,82,54,28,476,314,162,476,314,162,0.66,20.0,13.0,7.0,99.0,63.0,36.0,99.0,63.0,36.0,2013,0.65,2008-2018
1173,1173,Rick Adelman,MIN,3,23,82,40,42,230,97,133,1791,1042,749,0.5820000000000001,,,,,,,157.0,79.0,78.0,2013,,2008-2018
1175,1175,Mike Woodson,NYK,3,9,82,37,45,188,109,79,680,315,365,0.463,,,,17.0,7.0,10.0,46.0,18.0,28.0,2013,,2008-2018
1176,1176,Scott Brooks,OKC,6,6,82,59,23,463,293,170,463,293,170,0.633,19.0,10.0,9.0,73.0,39.0,34.0,73.0,39.0,34.0,2013,0.5263157894736842,2008-2018
1180,1180,Terry Stotts,POR,2,6,82,54,28,164,87,77,447,202,245,0.452,11.0,5.0,6.0,11.0,5.0,6.0,16.0,6.0,10.0,2013,0.45454545454545453,2008-2018
1182,1182,Gregg Popovich,SAS,18,18,82,62,20,1410,967,443,1410,967,443,0.6859999999999999,23.0,16.0,7.0,239.0,149.0,90.0,239.0,149.0,90.0,2013,0.6956521739130435,2008-2018
1183,1183,Dwane Casey,TOR,3,5,82,48,34,230,105,125,352,158,194,0.449,7.0,3.0,4.0,7.0,3.0,4.0,7.0,3.0,4.0,2013,0.42857142857142855,2008-2018
1185,1185,Randy Wittman,WAS,3,8,82,44,38,213,91,122,520,191,329,0.3670000000000001,11.0,6.0,5.0,11.0,6.0,5.0,11.0,6.0,5.0,2013,0.5454545454545454,2008-2018
1186,1186,Mike Woodson,ATL,1,1,82,13,69,82,13,69,82,13,69,0.159,,,,,,,,,,2004,,1998-2008
1187,1187,Doc Rivers,BOS,1,6,82,45,37,82,45,37,421,216,205,0.513,7.0,3.0,4.0,7.0,3.0,4.0,22.0,8.0,14.0,2004,0.42857142857142855,1998-2008
1188,1188,Bernie Bickerstaff,CHO,1,11,82,18,64,82,18,64,768,356,412,0.464,,,,,,,33.0,12.0,21.0,2004,,1998-2008
1189,1189,Scott Skiles,CHI,2,5,82,47,35,148,66,82,343,182,161,0.531,6.0,2.0,4.0,6.0,2.0,4.0,19.0,7.0,12.0,2004,0.3333333333333333,1998-2008
1190,1190,Paul Silas,CLE,2,10,64,34,30,146,69,77,755,355,400,0.47,,,,,,,29.0,13.0,16.0,2004,,1998-2008
1192,1192,Don Nelson,DAL,8,27,64,42,22,590,339,251,2070,1190,880,0.575,,,,43.0,19.0,24.0,155.0,70.0,85.0,2004,,1998-2008
1196,1196,George Karl,DEN,1,17,40,32,8,40,32,8,1247,740,507,0.593,5.0,1.0,4.0,5.0,1.0,4.0,131.0,60.0,71.0,2004,0.2,1998-2008
1197,1197,Larry Brown,DET,2,26,82,54,28,164,108,56,2064,1216,848,0.589,25.0,15.0,10.0,48.0,31.0,17.0,231.0,120.0,111.0,2004,0.6,1998-2008
1199,1199,Jeff Van Gundy,HOU,2,9,82,51,31,164,96,68,584,344,240,0.589,7.0,3.0,4.0,12.0,4.0,8.0,81.0,41.0,40.0,2004,0.42857142857142855,1998-2008
1200,1200,Rick Carlisle,IND,2,4,82,44,38,164,105,59,328,205,123,0.625,13.0,6.0,7.0,29.0,16.0,13.0,56.0,28.0,28.0,2004,0.46153846153846156,1998-2008
1201,1201,Mike Dunleavy,LAC,2,12,82,37,45,164,65,99,952,463,489,0.486,,,,,,,59.0,31.0,28.0,2004,,1998-2008
1202,1202,Rudy Tomjanovich,LAL,1,13,43,24,19,43,24,19,943,527,416,0.5589999999999999,,,,,,,90.0,51.0,39.0,2004,,1998-2008
1204,1204,Hubie Brown,MEM,3,15,12,5,7,168,83,85,1087,528,559,0.486,,,,4.0,0.0,4.0,63.0,31.0,32.0,2004,,1998-2008
1205,1205,Lionel Hollins,MEM,2,2,4,0,4,64,18,46,64,18,46,0.281,,,,,,,,,,2004,,1998-2008
1206,1206,Mike Fratello,MEM,1,15,66,40,26,66,40,26,1103,612,491,0.555,4.0,0.0,4.0,4.0,0.0,4.0,58.0,20.0,38.0,2004,0.0,1998-2008
1207,1207,Stan Van Gundy,MIA,2,2,82,59,23,164,101,63,164,101,63,0.616,15.0,11.0,4.0,28.0,17.0,11.0,28.0,17.0,11.0,2004,0.7333333333333333,1998-2008
1209,1209,Flip Saunders,MIN,10,10,51,25,26,737,411,326,737,411,326,0.5579999999999999,,,,47.0,17.0,30.0,47.0,17.0,30.0,2004,,1998-2008
1211,1211,Lawrence Frank,BRK,2,2,82,42,40,122,67,55,122,67,55,0.5489999999999999,4.0,0.0,4.0,15.0,7.0,8.0,15.0,7.0,8.0,2004,0.0,1998-2008
1212,1212,Byron Scott,NOP,1,5,82,18,64,82,18,64,370,167,203,0.451,,,,,,,40.0,25.0,15.0,2004,,1998-2008
1213,1213,Lenny Wilkens,NYK,2,32,39,17,22,81,40,41,2487,1332,1155,0.536,,,,4.0,0.0,4.0,178.0,80.0,98.0,2004,,1998-2008
1217,1217,Jim O'Brien,PHI,1,5,82,43,39,82,43,39,340,182,158,0.535,5.0,1.0,4.0,5.0,1.0,4.0,31.0,14.0,17.0,2004,0.2,1998-2008
1218,1218,Mike D'Antoni,PHO,2,3,82,62,20,143,83,60,193,97,96,0.503,15.0,9.0,6.0,15.0,9.0,6.0,15.0,9.0,6.0,2004,0.6,1998-2008
1219,1219,Maurice Cheeks,POR,4,4,55,22,33,301,162,139,301,162,139,0.5379999999999999,,,,10.0,3.0,7.0,10.0,3.0,7.0,2004,,1998-2008
1221,1221,Rick Adelman,SAC,7,15,82,50,32,542,351,191,1151,708,443,0.615,5.0,1.0,4.0,63.0,32.0,31.0,132.0,68.0,64.0,2004,0.2,1998-2008
1222,1222,Gregg Popovich,SAS,9,9,82,59,23,688,455,233,688,455,233,0.6609999999999999,23.0,16.0,7.0,110.0,69.0,41.0,110.0,69.0,41.0,2004,0.6956521739130435,1998-2008
1223,1223,Nate McMillan,OKC,5,5,82,52,30,395,212,183,395,212,183,0.537,11.0,6.0,5.0,16.0,8.0,8.0,16.0,8.0,8.0,2004,0.5454545454545454,1998-2008
1225,1225,Jerry Sloan,UTA,17,20,82,26,56,1345,849,496,1560,943,617,0.604,,,,152.0,76.0,76.0,158.0,78.0,80.0,2004,,1998-2008
1226,1226,Eddie Jordan,WAS,2,4,82,45,37,164,70,94,261,103,158,0.395,10.0,4.0,6.0,10.0,4.0,6.0,10.0,4.0,6.0,2004,0.4,1998-2008
1229,1229,Jim O'Brien,BOS,1,1,48,24,24,48,24,24,48,24,24,0.5,,,,,,,,,,2000,,1998-2008
1230,1230,Paul Silas,NOP,3,6,82,46,36,199,117,82,445,195,250,0.438,10.0,6.0,4.0,14.0,7.0,7.0,14.0,7.0,7.0,2000,0.6,1998-2008
1232,1232,Randy Wittman,CLE,2,2,82,30,52,164,62,102,164,62,102,0.378,,,,,,,,,,2000,,1998-2008
1233,1233,Don Nelson,DAL,4,23,82,53,29,280,128,152,1760,979,781,0.556,10.0,4.0,6.0,10.0,4.0,6.0,122.0,55.0,67.0,2000,0.4,1998-2008
1237,1237,Rudy Tomjanovich,HOU,10,10,82,45,37,736,432,304,736,432,304,0.5870000000000001,,,,90.0,51.0,39.0,90.0,51.0,39.0,2000,,1998-2008
1239,1239,Alvin Gentry,LAC,1,5,82,31,51,82,31,51,263,119,144,0.452,,,,,,,5.0,2.0,3.0,2000,,1998-2008
1240,1240,Phil Jackson,LAL,2,11,82,56,26,164,123,41,902,668,234,0.741,16.0,15.0,1.0,39.0,30.0,9.0,191.0,141.0,50.0,2000,0.9375,1998-2008
1241,1241,Pat Riley,MIA,6,19,82,50,32,460,293,167,1515,1049,466,0.6920000000000001,3.0,0.0,3.0,43.0,18.0,25.0,255.0,155.0,100.0,2000,0.0,1998-2008
1242,1242,George Karl,MIL,3,14,82,52,30,214,122,92,1043,625,418,0.599,18.0,10.0,8.0,26.0,12.0,14.0,120.0,57.0,63.0,2000,0.5555555555555556,1998-2008
1243,1243,Flip Saunders,MIN,6,6,82,47,35,440,227,213,440,227,213,0.516,4.0,1.0,3.0,20.0,5.0,15.0,20.0,5.0,15.0,2000,0.25,1998-2008
1244,1244,Byron Scott,BRK,1,1,82,26,56,82,26,56,82,26,56,0.317,,,,,,,,,,2000,,1998-2008
1245,1245,Jeff Van Gundy,NYK,6,6,82,48,34,401,238,163,401,238,163,0.594,5.0,2.0,3.0,69.0,37.0,32.0,69.0,37.0,32.0,2000,0.4,1998-2008
1246,1246,Doc Rivers,ORL,2,2,82,43,39,164,84,80,164,84,80,0.512,4.0,1.0,3.0,4.0,1.0,3.0,4.0,1.0,3.0,2000,0.25,1998-2008
1247,1247,Larry Brown,PHI,4,22,82,56,26,296,164,132,1736,1017,719,0.586,23.0,12.0,11.0,41.0,20.0,21.0,166.0,81.0,85.0,2000,0.5217391304347826,1998-2008
1248,1248,Scott Skiles,PHO,2,2,82,51,31,144,91,53,144,91,53,0.632,4.0,1.0,3.0,13.0,5.0,8.0,13.0,5.0,8.0,2000,0.25,1998-2008
1249,1249,Mike Dunleavy,POR,4,10,82,50,32,296,190,106,788,398,390,0.505,3.0,0.0,3.0,36.0,18.0,18.0,59.0,31.0,28.0,2000,0.0,1998-2008
1250,1250,Rick Adelman,SAC,3,11,82,55,27,214,126,88,823,483,340,0.5870000000000001,8.0,3.0,5.0,18.0,7.0,11.0,87.0,43.0,44.0,2000,0.375,1998-2008
1251,1251,Gregg Popovich,SAS,5,5,82,58,24,360,221,139,360,221,139,0.614,13.0,7.0,6.0,43.0,27.0,16.0,43.0,27.0,16.0,2000,0.5384615384615384,1998-2008
1252,1252,Paul Westphal,OKC,3,7,15,6,9,147,76,71,426,267,159,0.627,,,,5.0,2.0,3.0,49.0,27.0,22.0,2000,,1998-2008
1253,1253,Nate McMillan,OKC,1,1,67,38,29,67,38,29,67,38,29,0.5670000000000001,,,,,,,,,,2000,,1998-2008
1254,1254,Lenny Wilkens,TOR,1,28,82,47,35,82,47,35,2242,1226,1016,0.547,12.0,6.0,6.0,12.0,6.0,6.0,169.0,78.0,91.0,2000,0.5,1998-2008
1255,1255,Jerry Sloan,UTA,13,16,82,53,29,1017,690,327,1232,784,448,0.636,5.0,2.0,3.0,143.0,74.0,69.0,149.0,76.0,73.0,2000,0.4,1998-2008
1258,1258,Red Auerbach,BOS,11,15,79,57,22,792,502,290,1017,645,372,0.634,10.0,8.0,2.0,82.0,47.0,35.0,102.0,56.0,46.0,1960,0.8,1959-69
1264,1264,Paul Seymour,ATL,1,5,79,51,28,79,51,28,358,206,152,0.575,12.0,5.0,7.0,12.0,5.0,7.0,32.0,14.0,18.0,1960,0.4166666666666667,1959-69
1265,1265,Alex Hannum,PHI,1,3,79,38,41,79,38,41,182,94,88,0.516,8.0,4.0,4.0,8.0,4.0,4.0,29.0,18.0,11.0,1960,0.5,1959-69
1266,1266,Mike Fratello,ATL,7,7,82,52,30,495,283,212,495,283,212,0.5720000000000001,5.0,2.0,3.0,40.0,18.0,22.0,40.0,18.0,22.0,1988,0.4,1979-1988
1269,1269,Doug Collins,CHI,3,3,82,47,35,246,137,109,246,137,109,0.557,17.0,9.0,8.0,30.0,13.0,17.0,30.0,13.0,17.0,1988,0.5294117647058824,1979-1988
1270,1270,Lenny Wilkens,CLE,3,16,82,57,25,246,130,116,1290,683,607,0.529,5.0,2.0,3.0,10.0,4.0,6.0,79.0,41.0,38.0,1988,0.4,1979-1988
1271,1271,John MacLeod,DAL,2,16,82,38,44,164,91,73,1286,670,616,0.521,,,,17.0,10.0,7.0,98.0,47.0,51.0,1988,,1979-1988
1272,1272,Doug Moe,DEN,9,13,82,44,38,707,389,318,1019,566,453,0.555,3.0,0.0,3.0,58.0,24.0,34.0,80.0,33.0,47.0,1988,0.0,1979-1988
1273,1273,Chuck Daly,DET,6,7,82,63,19,492,310,182,533,319,214,0.598,17.0,15.0,2.0,73.0,47.0,26.0,73.0,47.0,26.0,1988,0.8823529411764706,1979-1988
1274,1274,Don Nelson,GSW,1,12,82,43,39,82,43,39,966,583,383,0.604,8.0,4.0,4.0,8.0,4.0,4.0,96.0,46.0,50.0,1988,0.5,1979-1988
1275,1275,Don Chaney,HOU,1,4,82,45,37,82,45,37,267,98,169,0.3670000000000001,4.0,1.0,3.0,4.0,1.0,3.0,4.0,1.0,3.0,1988,0.25,1979-1988
1276,1276,Jack Ramsay,IND,3,21,7,0,7,171,79,92,1647,864,783,0.525,,,,4.0,1.0,3.0,102.0,44.0,58.0,1988,,1979-1988
1280,1280,Gene Shue,LAC,4,22,38,10,28,284,105,179,1645,784,861,0.477,,,,,,,77.0,30.0,47.0,1988,,1979-1988
1282,1282,Pat Riley,LAL,8,8,82,57,25,645,470,175,645,470,175,0.7290000000000001,15.0,11.0,4.0,140.0,98.0,42.0,140.0,98.0,42.0,1988,0.7333333333333333,1979-1988
1284,1284,Del Harris,MIL,2,6,82,49,33,164,91,73,492,232,260,0.472,9.0,3.0,6.0,14.0,5.0,9.0,45.0,20.0,25.0,1988,0.3333333333333333,1979-1988
1287,1287,Jim Lynam,PHI,2,4,82,46,36,121,62,59,264,114,150,0.4320000000000001,3.0,0.0,3.0,3.0,0.0,3.0,3.0,0.0,3.0,1988,0.0,1979-1988
1288,1288,Cotton Fitzsimmons,PHO,3,16,82,55,27,246,152,94,1304,643,661,0.493,12.0,7.0,5.0,12.0,7.0,5.0,52.0,20.0,32.0,1988,0.5833333333333334,1979-1988
1290,1290,Rick Adelman,POR,1,1,35,14,21,35,14,21,35,14,21,0.4,3.0,0.0,3.0,3.0,0.0,3.0,3.0,0.0,3.0,1988,0.0,1979-1988
1292,1292,Larry Brown,SAS,1,10,82,21,61,82,21,61,793,467,326,0.589,,,,,,,63.0,28.0,35.0,1988,,1979-1988
1293,1293,Bernie Bickerstaff,OKC,4,4,82,47,35,328,161,167,328,161,167,0.491,8.0,3.0,5.0,27.0,12.0,15.0,27.0,12.0,15.0,1988,0.375,1979-1988
1294,1294,Frank Layden,UTA,8,8,17,11,6,571,277,294,571,277,294,0.485,,,,41.0,18.0,23.0,41.0,18.0,23.0,1988,,1979-1988
1295,1295,Jerry Sloan,UTA,1,4,65,40,25,65,40,25,280,134,146,0.479,3.0,0.0,3.0,3.0,0.0,3.0,9.0,2.0,7.0,1988,0.0,1979-1988
1297,1297,Terry Stotts,ATL,2,2,82,28,54,137,52,85,137,52,85,0.38,,,,,,,,,,2003,,1998-2008
1298,1298,Jim O'Brien,BOS,4,4,46,22,24,258,139,119,258,139,119,0.539,,,,26.0,13.0,13.0,26.0,13.0,13.0,2003,,1998-2008
1302,1302,Scott Skiles,CHI,1,4,66,19,47,66,19,47,261,135,126,0.517,,,,,,,13.0,5.0,8.0,2003,,1998-2008
1303,1303,Paul Silas,CLE,1,9,82,35,47,82,35,47,691,321,370,0.465,,,,,,,29.0,13.0,16.0,2003,,1998-2008
1304,1304,Don Nelson,DAL,7,26,82,52,30,526,297,229,2006,1148,858,0.5720000000000001,5.0,1.0,4.0,43.0,19.0,24.0,155.0,70.0,85.0,2003,0.2,1998-2008
1306,1306,Larry Brown,DET,1,25,82,54,28,82,54,28,1982,1162,820,0.586,23.0,16.0,7.0,23.0,16.0,7.0,206.0,105.0,101.0,2003,0.6956521739130435,1998-2008
1308,1308,Jeff Van Gundy,HOU,1,8,82,45,37,82,45,37,502,293,209,0.584,5.0,1.0,4.0,5.0,1.0,4.0,74.0,38.0,36.0,2003,0.2,1998-2008
1309,1309,Rick Carlisle,IND,1,3,82,61,21,82,61,21,246,161,85,0.654,16.0,10.0,6.0,16.0,10.0,6.0,43.0,22.0,21.0,2003,0.625,1998-2008
1310,1310,Mike Dunleavy,LAC,1,11,82,28,54,82,28,54,870,426,444,0.49,,,,,,,59.0,31.0,28.0,2003,,1998-2008
1311,1311,Phil Jackson,LAL,5,14,82,56,26,410,287,123,1148,832,316,0.725,22.0,13.0,9.0,92.0,64.0,28.0,244.0,175.0,69.0,2003,0.5909090909090909,1998-2008
1312,1312,Hubie Brown,MEM,2,14,82,50,32,156,78,78,1075,523,552,0.487,4.0,0.0,4.0,4.0,0.0,4.0,63.0,31.0,32.0,2003,0.0,1998-2008
1313,1313,Stan Van Gundy,MIA,1,1,82,42,40,82,42,40,82,42,40,0.512,13.0,6.0,7.0,13.0,6.0,7.0,13.0,6.0,7.0,2003,0.46153846153846156,1998-2008
1315,1315,Flip Saunders,MIN,9,9,82,58,24,686,386,300,686,386,300,0.563,18.0,10.0,8.0,47.0,17.0,30.0,47.0,17.0,30.0,2003,0.5555555555555556,1998-2008
1316,1316,Byron Scott,BRK,4,4,42,22,20,288,149,139,288,149,139,0.517,,,,40.0,25.0,15.0,40.0,25.0,15.0,2003,,1998-2008
1317,1317,Lawrence Frank,BRK,1,1,40,25,15,40,25,15,40,25,15,0.625,11.0,7.0,4.0,11.0,7.0,4.0,11.0,7.0,4.0,2003,0.6363636363636364,1998-2008
1319,1319,Don Chaney,NYK,3,12,39,15,24,184,72,112,831,337,494,0.406,,,,,,,11.0,2.0,9.0,2003,,1998-2008
1321,1321,Lenny Wilkens,NYK,1,31,42,23,19,42,23,19,2448,1315,1133,0.537,4.0,0.0,4.0,4.0,0.0,4.0,178.0,80.0,98.0,2003,0.0,1998-2008
1322,1322,Doc Rivers,ORL,5,5,11,1,10,339,171,168,339,171,168,0.504,,,,15.0,5.0,10.0,15.0,5.0,10.0,2003,,1998-2008
1325,1325,Chris Ford,PHI,1,10,30,12,18,30,12,18,699,323,376,0.462,,,,,,,29.0,13.0,16.0,2003,,1998-2008
1327,1327,Mike D'Antoni,PHO,1,2,61,21,40,61,21,40,111,35,76,0.315,,,,,,,,,,2003,,1998-2008
1328,1328,Maurice Cheeks,POR,3,3,82,41,41,246,140,106,246,140,106,0.569,,,,10.0,3.0,7.0,10.0,3.0,7.0,2003,,1998-2008
1329,1329,Rick Adelman,SAC,6,14,82,55,27,460,301,159,1069,658,411,0.616,12.0,7.0,5.0,58.0,31.0,27.0,127.0,67.0,60.0,2003,0.5833333333333334,1998-2008
1330,1330,Gregg Popovich,SAS,8,8,82,57,25,606,396,210,606,396,210,0.653,10.0,6.0,4.0,87.0,53.0,34.0,87.0,53.0,34.0,2003,0.6,1998-2008
1331,1331,Nate McMillan,OKC,4,4,82,37,45,313,160,153,313,160,153,0.511,,,,5.0,2.0,3.0,5.0,2.0,3.0,2003,,1998-2008
1333,1333,Jerry Sloan,UTA,16,19,82,42,40,1263,823,440,1478,917,561,0.62,,,,152.0,76.0,76.0,158.0,78.0,80.0,2003,,1998-2008
1334,1334,Eddie Jordan,WAS,1,3,82,25,57,82,25,57,179,58,121,0.324,,,,,,,,,,2003,,1998-2008
1335,1335,Mike Fratello,ATL,2,2,82,40,42,85,40,45,85,40,45,0.471,5.0,2.0,3.0,5.0,2.0,3.0,5.0,2.0,3.0,1983,0.4,1979-1988
1336,1336,K.C. Jones,BOS,1,5,82,62,20,82,62,20,412,247,165,0.6,23.0,15.0,8.0,23.0,15.0,8.0,58.0,29.0,29.0,1983,0.6521739130434783,1979-1988
1337,1337,Kevin Loughery,CHI,1,12,82,27,55,82,27,55,892,414,478,0.464,,,,,,,39.0,22.0,17.0,1983,,1979-1988
1338,1338,Tom Nissalke,CLE,2,13,82,28,54,164,51,113,879,371,508,0.422,,,,,,,31.0,11.0,20.0,1983,,1979-1988
1339,1339,Dick Motta,DAL,4,16,82,43,39,328,124,204,1312,665,647,0.507,10.0,4.0,6.0,10.0,4.0,6.0,108.0,49.0,59.0,1983,0.4,1979-1988
1340,1340,Doug Moe,DEN,4,8,82,38,44,297,155,142,609,332,277,0.545,5.0,2.0,3.0,16.0,6.0,10.0,38.0,15.0,23.0,1983,0.4,1979-1988
1341,1341,Chuck Daly,DET,1,2,82,49,33,82,49,33,123,58,65,0.472,5.0,2.0,3.0,5.0,2.0,3.0,5.0,2.0,3.0,1983,0.4,1979-1988
1343,1343,Bill Fitch,HOU,1,14,82,29,53,82,29,53,1148,575,573,0.501,,,,,,,63.0,33.0,30.0,1983,,1979-1988
1345,1345,Cotton Fitzsimmons,SAC,6,13,82,38,44,492,248,244,1058,512,546,0.484,3.0,0.0,3.0,26.0,9.0,17.0,32.0,11.0,21.0,1983,0.0,1979-1988
1346,1346,Pat Riley,LAL,3,3,82,54,28,235,162,73,235,162,73,0.6890000000000001,21.0,14.0,7.0,50.0,34.0,16.0,50.0,34.0,16.0,1983,0.6666666666666666,1979-1988
1347,1347,Don Nelson,MIL,8,8,82,50,32,638,374,264,638,374,264,0.586,16.0,8.0,8.0,54.0,26.0,28.0,54.0,26.0,28.0,1983,0.5,1979-1988
1349,1349,Hubie Brown,NYK,2,9,82,47,35,164,91,73,739,394,345,0.5329999999999999,12.0,6.0,6.0,18.0,8.0,10.0,59.0,31.0,28.0,1983,0.5,1979-1988
1350,1350,Billy Cunningham,PHI,7,7,82,52,30,568,396,172,568,396,172,0.6970000000000001,5.0,2.0,3.0,92.0,58.0,34.0,92.0,58.0,34.0,1983,0.4,1979-1988
1351,1351,John MacLeod,PHO,11,11,82,41,41,902,489,413,902,489,413,0.542,17.0,9.0,8.0,78.0,37.0,41.0,78.0,37.0,41.0,1983,0.5294117647058824,1979-1988
1352,1352,Jack Ramsay,POR,8,16,82,48,34,656,371,285,1312,703,609,0.536,5.0,2.0,3.0,46.0,24.0,22.0,85.0,38.0,47.0,1983,0.4,1979-1988
1355,1355,Jim Lynam,LAC,1,1,82,30,52,82,30,52,82,30,52,0.366,,,,,,,,,,1983,,1979-1988
1356,1356,Lenny Wilkens,OKC,10,12,82,42,40,798,447,351,962,522,440,0.5429999999999999,5.0,2.0,3.0,69.0,37.0,32.0,69.0,37.0,32.0,1983,0.4,1979-1988
1357,1357,Frank Layden,UTA,3,3,82,45,37,226,92,134,226,92,134,0.407,11.0,5.0,6.0,11.0,5.0,6.0,11.0,5.0,6.0,1983,0.45454545454545453,1979-1988
1358,1358,Gene Shue,WAS,11,18,82,35,47,876,450,426,1374,685,689,0.499,4.0,1.0,3.0,51.0,18.0,33.0,73.0,29.0,44.0,1983,0.25,1979-1988
1360,1360,Chris Ford,BOS,2,2,82,51,31,164,107,57,164,107,57,0.652,10.0,6.0,4.0,21.0,11.0,10.0,21.0,11.0,10.0,1991,0.6,1988-1998
1362,1362,Phil Jackson,CHI,3,3,82,67,15,246,183,63,246,183,63,0.7440000000000001,22.0,15.0,7.0,55.0,40.0,15.0,55.0,40.0,15.0,1991,0.6818181818181818,1988-1998
1363,1363,Lenny Wilkens,CLE,6,19,82,57,25,492,262,230,1536,815,721,0.531,17.0,9.0,8.0,32.0,15.0,17.0,101.0,52.0,49.0,1991,0.5294117647058824,1988-1998
1366,1366,Chuck Daly,DET,9,10,82,48,34,738,467,271,779,476,303,0.611,5.0,2.0,3.0,113.0,71.0,42.0,113.0,71.0,42.0,1991,0.4,1988-1998
1367,1367,Don Nelson,GSW,4,15,82,55,27,328,179,149,1212,719,493,0.593,4.0,1.0,3.0,21.0,9.0,12.0,109.0,51.0,58.0,1991,0.25,1988-1998
1368,1368,Don Chaney,HOU,4,7,52,26,26,298,164,134,483,217,266,0.449,,,,11.0,2.0,9.0,11.0,2.0,9.0,1991,,1988-1998
1369,1369,Rudy Tomjanovich,HOU,1,1,30,16,14,30,16,14,30,16,14,0.5329999999999999,,,,,,,,,,1991,,1988-1998
1370,1370,Bob Hill,IND,2,3,82,40,42,139,72,67,205,92,113,0.449,3.0,0.0,3.0,8.0,2.0,6.0,8.0,2.0,6.0,1991,0.0,1988-1998
1373,1373,Larry Brown,LAC,1,13,35,23,12,35,23,12,1030,622,408,0.604,5.0,2.0,3.0,5.0,2.0,3.0,82.0,37.0,45.0,1991,0.4,1988-1998
1374,1374,Mike Dunleavy,LAL,2,2,82,43,39,164,101,63,164,101,63,0.616,4.0,1.0,3.0,23.0,13.0,10.0,23.0,13.0,10.0,1991,0.25,1988-1998
1375,1375,Kevin Loughery,MIA,1,17,82,38,44,82,38,44,1178,547,631,0.464,3.0,0.0,3.0,3.0,0.0,3.0,54.0,25.0,29.0,1991,0.0,1988-1998
1376,1376,Del Harris,MIL,5,9,17,8,9,345,191,154,673,332,341,0.493,,,,21.0,6.0,15.0,52.0,21.0,31.0,1991,,1988-1998
1379,1379,Bill Fitch,BRK,3,21,82,40,42,246,83,163,1722,845,877,0.491,4.0,1.0,3.0,4.0,1.0,3.0,106.0,55.0,51.0,1991,0.25,1988-1998
1380,1380,Pat Riley,NYK,1,10,82,51,31,82,51,31,809,584,225,0.722,12.0,6.0,6.0,12.0,6.0,6.0,161.0,108.0,53.0,1991,0.5,1988-1998
1382,1382,Jim Lynam,PHI,5,7,82,35,47,367,194,173,510,246,264,0.482,,,,21.0,8.0,13.0,21.0,8.0,13.0,1991,,1988-1998
1383,1383,Cotton Fitzsimmons,PHO,6,19,82,53,29,492,314,178,1550,805,745,0.519,8.0,4.0,4.0,40.0,21.0,19.0,80.0,34.0,46.0,1991,0.5,1988-1998
1384,1384,Rick Adelman,POR,4,4,82,57,25,281,193,88,281,193,88,0.687,21.0,13.0,8.0,61.0,34.0,27.0,61.0,34.0,27.0,1991,0.6190476190476191,1988-1998
1385,1385,Dick Motta,SAC,3,22,25,7,18,161,48,113,1719,856,863,0.498,,,,,,,126.0,56.0,70.0,1991,,1988-1998
1387,1387,Larry Brown,SAS,4,13,38,21,17,284,153,131,1030,622,408,0.604,,,,14.0,7.0,7.0,82.0,37.0,45.0,1991,,1988-1998
1389,1389,K.C. Jones,OKC,2,11,36,18,18,118,59,59,858,552,306,0.643,,,,5.0,2.0,3.0,142.0,81.0,61.0,1991,,1988-1998
1391,1391,George Karl,OKC,1,5,42,27,15,42,27,15,337,146,191,0.433,9.0,4.0,5.0,9.0,4.0,5.0,23.0,9.0,14.0,1991,0.4444444444444444,1988-1998
1392,1392,Jerry Sloan,UTA,4,7,82,55,27,311,204,107,526,298,228,0.5670000000000001,16.0,9.0,7.0,33.0,15.0,18.0,39.0,17.0,22.0,1991,0.5625,1988-1998
1394,1394,Hubie Brown,ATL,5,7,79,31,48,407,199,208,575,303,272,0.527,,,,16.0,6.0,10.0,41.0,23.0,18.0,1980,,1979-1988
1395,1395,Mike Fratello,ATL,1,1,3,0,3,3,0,3,3,0,3,0.0,,,,,,,,,,1980,,1979-1988
1396,1396,Bill Fitch,BOS,2,11,82,62,20,164,123,41,902,427,475,0.473,17.0,12.0,5.0,26.0,17.0,9.0,44.0,24.0,20.0,1980,0.7058823529411765,1979-1988
1397,1397,Jerry Sloan,CHI,2,2,82,45,37,164,75,89,164,75,89,0.457,6.0,2.0,4.0,6.0,2.0,4.0,6.0,2.0,4.0,1980,0.3333333333333333,1979-1988
1400,1400,Dick Motta,DAL,1,13,82,15,67,82,15,67,1066,556,510,0.522,,,,,,,98.0,45.0,53.0,1980,,1979-1988
1402,1402,Doug Moe,DEN,1,5,51,26,25,51,26,25,363,203,160,0.5589999999999999,,,,,,,22.0,9.0,13.0,1980,,1979-1988
1404,1404,Al Attles,GSW,12,12,82,39,43,911,482,429,911,482,429,0.529,,,,61.0,31.0,30.0,61.0,31.0,30.0,1980,,1979-1988
1405,1405,Del Harris,HOU,2,2,82,40,42,164,81,83,164,81,83,0.494,21.0,12.0,9.0,28.0,14.0,14.0,28.0,14.0,14.0,1980,0.5714285714285714,1979-1988
1407,1407,Cotton Fitzsimmons,SAC,3,10,82,40,42,246,135,111,812,399,413,0.491,15.0,7.0,8.0,23.0,9.0,14.0,29.0,11.0,18.0,1980,0.4666666666666667,1979-1988
1409,1409,Don Nelson,MIL,5,5,82,60,22,392,218,174,392,218,174,0.556,7.0,3.0,4.0,23.0,11.0,12.0,23.0,11.0,12.0,1980,0.42857142857142855,1979-1988
1410,1410,Kevin Loughery,BRK,8,9,35,12,23,615,297,318,646,302,344,0.467,,,,34.0,21.0,13.0,34.0,21.0,13.0,1980,,1979-1988
1412,1412,Red Holzman,NYK,13,17,82,50,32,1014,580,434,1217,663,554,0.545,2.0,0.0,2.0,97.0,54.0,43.0,105.0,58.0,47.0,1980,0.0,1979-1988
1413,1413,Billy Cunningham,PHI,4,4,82,62,20,322,221,101,322,221,101,0.6859999999999999,16.0,9.0,7.0,53.0,32.0,21.0,53.0,32.0,21.0,1980,0.5625,1979-1988
1414,1414,John MacLeod,PHO,8,8,82,57,25,656,349,307,656,349,307,0.532,7.0,3.0,4.0,51.0,25.0,26.0,51.0,25.0,26.0,1980,0.42857142857142855,1979-1988
1415,1415,Jack Ramsay,POR,5,13,82,45,37,410,235,175,1066,567,499,0.532,3.0,1.0,2.0,34.0,19.0,15.0,73.0,33.0,40.0,1980,0.3333333333333333,1979-1988
1417,1417,Paul Silas,LAC,1,1,82,36,46,82,36,46,82,36,46,0.439,,,,,,,,,,1980,,1979-1988
1418,1418,Lenny Wilkens,OKC,7,9,82,34,48,552,305,247,716,380,336,0.531,,,,54.0,32.0,22.0,54.0,32.0,22.0,1980,,1979-1988
1419,1419,Tom Nissalke,UTA,2,10,82,28,54,164,52,112,695,312,383,0.449,,,,,,,31.0,11.0,20.0,1980,,1979-1988
1420,1420,Gene Shue,WAS,8,15,82,39,43,630,330,300,1128,565,563,0.501,,,,40.0,14.0,26.0,62.0,25.0,37.0,1980,,1979-1988
1421,1421,Red Auerbach,BOS,6,10,72,39,33,422,241,181,647,384,263,0.594,3.0,1.0,2.0,27.0,10.0,17.0,47.0,19.0,28.0,1955,0.3333333333333333,1950-59
1423,1423,John Kundla,LAL,8,8,72,33,39,548,346,202,548,346,202,0.631,3.0,1.0,2.0,77.0,52.0,25.0,77.0,52.0,25.0,1955,0.3333333333333333,1950-59
1428,1428,Red Holzman,ATL,3,3,72,33,39,170,69,101,170,69,101,0.406,8.0,4.0,4.0,8.0,4.0,4.0,8.0,4.0,4.0,1955,0.5,1950-59
1429,1429,Al Cervi,PHI,7,7,72,35,37,483,290,193,483,290,193,0.6,8.0,4.0,4.0,59.0,33.0,26.0,59.0,33.0,26.0,1955,0.5,1950-59
1430,1430,Red Auerbach,BOS,10,14,75,59,16,713,445,268,938,588,350,0.627,13.0,8.0,5.0,72.0,39.0,33.0,92.0,48.0,44.0,1959,0.6153846153846154,1950-59
1440,1440,Paul Seymour,PHI,4,4,75,45,30,279,155,124,279,155,124,0.556,3.0,1.0,2.0,20.0,9.0,11.0,20.0,9.0,11.0,1959,0.3333333333333333,1950-59
1441,1441,Mike Fratello,ATL,6,6,82,50,32,413,231,182,413,231,182,0.5589999999999999,12.0,6.0,6.0,35.0,16.0,19.0,35.0,16.0,19.0,1987,0.5,1979-1988
1442,1442,K.C. Jones,BOS,5,9,82,57,25,410,308,102,740,493,247,0.6659999999999999,17.0,9.0,8.0,102.0,65.0,37.0,137.0,79.0,58.0,1987,0.5294117647058824,1979-1988
1443,1443,Doug Collins,CHI,2,2,82,50,32,164,90,74,164,90,74,0.5489999999999999,10.0,4.0,6.0,13.0,4.0,9.0,13.0,4.0,9.0,1987,0.4,1979-1988
1444,1444,Lenny Wilkens,CLE,2,15,82,42,40,164,73,91,1208,626,582,0.518,5.0,2.0,3.0,5.0,2.0,3.0,74.0,39.0,35.0,1987,0.4,1979-1988
1445,1445,John MacLeod,DAL,1,15,82,53,29,82,53,29,1204,632,572,0.525,17.0,10.0,7.0,17.0,10.0,7.0,98.0,47.0,51.0,1987,0.5882352941176471,1979-1988
1446,1446,Doug Moe,DEN,8,12,82,54,28,625,345,280,937,522,415,0.557,11.0,5.0,6.0,55.0,24.0,31.0,77.0,33.0,44.0,1987,0.45454545454545453,1979-1988
1447,1447,Chuck Daly,DET,5,6,82,54,28,410,247,163,451,256,195,0.568,23.0,14.0,9.0,56.0,32.0,24.0,56.0,32.0,24.0,1987,0.6086956521739131,1979-1988
1448,1448,George Karl,GSW,2,4,64,16,48,146,58,88,295,119,176,0.403,,,,10.0,4.0,6.0,14.0,5.0,9.0,1987,,1979-1988
1450,1450,Bill Fitch,HOU,5,18,82,46,36,410,216,194,1476,762,714,0.516,4.0,1.0,3.0,39.0,21.0,18.0,102.0,54.0,48.0,1987,0.25,1979-1988
1451,1451,Jack Ramsay,IND,2,20,82,38,44,164,79,85,1640,864,776,0.527,,,,4.0,1.0,3.0,102.0,44.0,58.0,1987,,1979-1988
1452,1452,Gene Shue,LAC,3,21,82,17,65,246,95,151,1607,774,833,0.482,,,,,,,77.0,30.0,47.0,1987,,1979-1988
1453,1453,Pat Riley,LAL,7,7,82,62,20,563,413,150,563,413,150,0.7340000000000001,24.0,15.0,9.0,125.0,87.0,38.0,125.0,87.0,38.0,1987,0.625,1979-1988
1454,1454,Del Harris,MIL,1,5,82,42,40,82,42,40,410,183,227,0.446,5.0,2.0,3.0,5.0,2.0,3.0,36.0,17.0,19.0,1987,0.4,1979-1988
1460,1460,Jim Lynam,PHI,1,3,39,16,23,39,16,23,182,68,114,0.374,,,,,,,,,,1987,,1979-1988
1463,1463,Bill Russell,SAC,1,8,58,17,41,58,17,41,631,341,290,0.54,,,,,,,61.0,34.0,27.0,1987,,1979-1988
1466,1466,Bernie Bickerstaff,OKC,3,3,82,44,38,246,114,132,246,114,132,0.463,5.0,2.0,3.0,19.0,9.0,10.0,19.0,9.0,10.0,1987,0.4,1979-1988
1467,1467,Frank Layden,UTA,7,7,82,47,35,554,266,288,554,266,288,0.48,11.0,6.0,5.0,41.0,18.0,23.0,41.0,18.0,23.0,1987,0.5454545454545454,1979-1988
1468,1468,Kevin Loughery,WAS,3,16,27,8,19,122,57,65,1096,509,587,0.464,,,,8.0,2.0,6.0,51.0,25.0,26.0,1987,,1979-1988
1472,1472,Red Auerbach,BOS,1,5,69,39,30,69,39,30,294,182,112,0.619,2.0,0.0,2.0,2.0,0.0,2.0,22.0,9.0,13.0,1950,0.0,
1475,1475,John Kundla,LAL,3,3,68,44,24,196,139,57,196,139,57,0.7090000000000001,7.0,3.0,4.0,29.0,21.0,8.0,29.0,21.0,8.0,1950,0.42857142857142855,
1479,1479,Al Cervi,PHI,2,2,66,32,34,130,83,47,130,83,47,0.638,7.0,4.0,3.0,18.0,10.0,8.0,18.0,10.0,8.0,1950,0.5714285714285714,
1484,1484,Red Auerbach,BOS,9,13,72,52,20,638,386,252,863,529,334,0.613,11.0,8.0,3.0,59.0,31.0,28.0,79.0,40.0,39.0,1958,0.7272727272727273,1950-59
1488,1488,John Kundla,LAL,11,11,72,33,39,725,423,302,725,423,302,0.583,13.0,6.0,7.0,95.0,60.0,35.0,95.0,60.0,35.0,1958,0.46153846153846156,1950-59
1490,1490,Al Cervi,GSW,1,9,72,32,40,72,32,40,567,326,241,0.575,,,,,,,59.0,33.0,26.0,1958,,1950-59
1493,1493,Paul Seymour,PHI,3,3,72,35,37,204,110,94,204,110,94,0.539,9.0,5.0,4.0,17.0,8.0,9.0,17.0,8.0,9.0,1958,0.5555555555555556,1950-59
1496,1496,Red Auerbach,BOS,3,7,71,46,25,206,124,82,431,267,164,0.619,6.0,3.0,3.0,11.0,4.0,7.0,31.0,13.0,18.0,1952,0.5,1950-59
1500,1500,John Kundla,LAL,5,5,70,48,22,332,227,105,332,227,105,0.684,12.0,9.0,3.0,54.0,39.0,15.0,54.0,39.0,15.0,1952,0.75,1950-59
1504,1504,Al Cervi,PHI,4,4,71,47,24,267,170,97,267,170,97,0.637,2.0,0.0,2.0,27.0,13.0,14.0,27.0,13.0,14.0,1952,0.0,1950-59
1505,1505,Cotton Fitzsimmons,ATL,2,4,82,35,47,164,81,83,328,178,150,0.5429999999999999,,,,6.0,2.0,4.0,6.0,2.0,4.0,1973,,1969-1979
1506,1506,Tom Heinsohn,BOS,5,5,82,56,26,410,258,152,410,258,152,0.629,18.0,12.0,6.0,42.0,24.0,18.0,42.0,24.0,18.0,1973,0.6666666666666666,1969-1979
1507,1507,Jack Ramsay,LAC,2,6,82,42,40,164,63,101,492,237,255,0.482,6.0,2.0,4.0,6.0,2.0,4.0,23.0,7.0,16.0,1973,0.3333333333333333,1969-1979
1508,1508,K.C. Jones,WAS,1,2,82,47,35,82,47,35,166,77,89,0.464,7.0,3.0,4.0,7.0,3.0,4.0,11.0,3.0,8.0,1973,0.42857142857142855,1969-1979
1509,1509,Dick Motta,CHI,6,6,82,54,28,492,285,207,492,285,207,0.579,11.0,4.0,7.0,34.0,11.0,23.0,34.0,11.0,23.0,1973,0.36363636363636365,1969-1979
1510,1510,Bill Fitch,CLE,4,4,82,29,53,328,99,229,328,99,229,0.302,,,,,,,,,,1973,,1969-1979
1512,1512,Al Attles,GSW,5,5,82,44,38,358,191,167,358,191,167,0.534,,,,21.0,7.0,14.0,21.0,7.0,14.0,1973,,1969-1979
1516,1516,Phil Johnson,SAC,1,1,58,27,31,58,27,31,58,27,31,0.466,,,,,,,,,,1973,,1969-1979
1518,1518,Larry Costello,MIL,6,6,82,59,23,492,331,161,492,331,161,0.6729999999999999,16.0,11.0,5.0,57.0,36.0,21.0,57.0,36.0,21.0,1973,0.6875,1969-1979
1519,1519,Red Holzman,NYK,7,11,82,49,33,536,348,188,739,431,308,0.583,12.0,5.0,7.0,92.0,53.0,39.0,100.0,57.0,43.0,1973,0.4166666666666667,1969-1979
1520,1520,Gene Shue,PHI,1,8,82,25,57,82,25,57,630,316,314,0.502,,,,,,,40.0,14.0,26.0,1973,,1969-1979
1521,1521,John MacLeod,PHO,1,1,82,30,52,82,30,52,82,30,52,0.366,,,,,,,,,,1973,,1969-1979
1523,1523,Bill Russell,OKC,1,4,82,36,46,82,36,46,327,198,129,0.606,,,,,,,46.0,28.0,18.0,1973,,1969-1979
1524,1524,Hubie Brown,ATL,4,6,82,50,32,328,168,160,496,272,224,0.5479999999999999,5.0,1.0,4.0,16.0,6.0,10.0,41.0,23.0,18.0,1979,0.2,1969-1979
1525,1525,Bill Fitch,BOS,1,10,82,61,21,82,61,21,820,365,455,0.445,9.0,5.0,4.0,9.0,5.0,4.0,27.0,12.0,15.0,1979,0.5555555555555556,1969-1979
1526,1526,Jerry Sloan,CHI,1,1,82,30,52,82,30,52,82,30,52,0.366,,,,,,,,,,1979,,1969-1979
1531,1531,Al Attles,GSW,11,11,61,18,43,829,443,386,829,443,386,0.534,,,,61.0,31.0,30.0,61.0,31.0,30.0,1979,,1969-1979
1533,1533,Del Harris,HOU,1,1,82,41,41,82,41,41,82,41,41,0.5,7.0,2.0,5.0,7.0,2.0,5.0,7.0,2.0,5.0,1979,0.2857142857142857,1969-1979
1535,1535,Cotton Fitzsimmons,SAC,2,9,82,47,35,164,95,69,730,359,371,0.4920000000000001,3.0,1.0,2.0,8.0,2.0,6.0,14.0,4.0,10.0,1979,0.3333333333333333,1969-1979
1538,1538,Don Nelson,MIL,4,4,82,49,33,310,158,152,310,158,152,0.51,7.0,3.0,4.0,16.0,8.0,8.0,16.0,8.0,8.0,1979,0.42857142857142855,1969-1979
1539,1539,Kevin Loughery,BRK,7,8,82,34,48,580,285,295,611,290,321,0.475,,,,34.0,21.0,13.0,34.0,21.0,13.0,1979,,1969-1979
1540,1540,Red Holzman,NYK,12,16,82,39,43,932,530,402,1135,613,522,0.54,,,,95.0,54.0,41.0,103.0,58.0,45.0,1979,,1969-1979
1541,1541,Billy Cunningham,PHI,3,3,82,59,23,240,159,81,240,159,81,0.6629999999999999,18.0,12.0,6.0,37.0,23.0,14.0,37.0,23.0,14.0,1979,0.6666666666666666,1969-1979
1542,1542,John MacLeod,PHO,7,7,82,55,27,574,292,282,574,292,282,0.509,8.0,3.0,5.0,44.0,22.0,22.0,44.0,22.0,22.0,1979,0.375,1969-1979
1543,1543,Jack Ramsay,POR,4,12,82,38,44,328,190,138,984,522,462,0.53,3.0,1.0,2.0,31.0,18.0,13.0,70.0,32.0,38.0,1979,0.3333333333333333,1969-1979
1544,1544,Doug Moe,SAS,4,4,66,33,33,312,177,135,312,177,135,0.5670000000000001,,,,22.0,9.0,13.0,22.0,9.0,13.0,1979,,1969-1979
1546,1546,Gene Shue,LAC,2,14,82,35,47,164,78,86,1046,526,520,0.503,,,,,,,62.0,25.0,37.0,1979,,1969-1979
1547,1547,Lenny Wilkens,OKC,6,8,82,56,26,470,271,199,634,346,288,0.546,15.0,7.0,8.0,54.0,32.0,22.0,54.0,32.0,22.0,1979,0.4666666666666667,1969-1979
1548,1548,Tom Nissalke,UTA,1,9,82,24,58,82,24,58,613,284,329,0.463,,,,,,,31.0,11.0,20.0,1979,,1969-1979
1549,1549,Dick Motta,WAS,4,12,82,39,43,328,185,143,984,541,443,0.55,2.0,0.0,2.0,51.0,27.0,24.0,98.0,45.0,53.0,1979,0.0,1969-1979
1550,1550,Kevin Loughery,ATL,1,10,82,42,40,82,42,40,728,344,384,0.473,2.0,0.0,2.0,2.0,0.0,2.0,36.0,21.0,15.0,1981,0.0,1979-1988
1551,1551,Bill Fitch,BOS,3,12,82,63,19,246,186,60,984,490,494,0.498,12.0,7.0,5.0,38.0,24.0,14.0,56.0,31.0,25.0,1981,0.5833333333333334,1979-1988
1552,1552,Jerry Sloan,CHI,3,3,51,19,32,215,94,121,215,94,121,0.4370000000000001,,,,6.0,2.0,4.0,6.0,2.0,4.0,1981,,1979-1988
1553,1553,Phil Johnson,CHI,1,6,1,0,1,1,0,1,342,155,187,0.453,,,,,,,6.0,2.0,4.0,1981,,1979-1988
1557,1557,Chuck Daly,CLE,1,1,41,9,32,41,9,32,41,9,32,0.22,,,,,,,,,,1981,,1979-1988
1559,1559,Dick Motta,DAL,2,14,82,28,54,164,43,121,1148,584,564,0.509,,,,,,,98.0,45.0,53.0,1981,,1979-1988
1560,1560,Doug Moe,DEN,2,6,82,46,36,133,72,61,445,249,196,0.56,3.0,1.0,2.0,3.0,1.0,2.0,25.0,10.0,15.0,1981,0.3333333333333333,1979-1988
1562,1562,Al Attles,GSW,13,13,82,45,37,993,527,466,993,527,466,0.531,,,,61.0,31.0,30.0,61.0,31.0,30.0,1981,,1979-1988
1563,1563,Del Harris,HOU,3,3,82,46,36,246,127,119,246,127,119,0.516,3.0,1.0,2.0,31.0,15.0,16.0,31.0,15.0,16.0,1981,0.3333333333333333,1979-1988
1565,1565,Cotton Fitzsimmons,SAC,4,11,82,30,52,328,165,163,894,429,465,0.48,,,,23.0,9.0,14.0,29.0,11.0,18.0,1981,,1979-1988
1567,1567,Pat Riley,LAL,1,1,71,50,21,71,50,21,71,50,21,0.7040000000000001,14.0,12.0,2.0,14.0,12.0,2.0,14.0,12.0,2.0,1981,0.8571428571428571,1979-1988
1568,1568,Don Nelson,MIL,6,6,82,55,27,474,273,201,474,273,201,0.5760000000000001,6.0,2.0,4.0,29.0,13.0,16.0,29.0,13.0,16.0,1981,0.3333333333333333,1979-1988
1569,1569,Larry Brown,BRK,1,8,82,44,38,82,44,38,635,399,236,0.628,2.0,0.0,2.0,2.0,0.0,2.0,63.0,28.0,35.0,1981,0.0,1979-1988
1570,1570,Red Holzman,NYK,14,18,82,33,49,1096,613,483,1299,696,603,0.536,,,,97.0,54.0,43.0,105.0,58.0,47.0,1981,,1979-1988
1571,1571,Billy Cunningham,PHI,5,5,82,58,24,404,279,125,404,279,125,0.691,21.0,12.0,9.0,74.0,44.0,30.0,74.0,44.0,30.0,1981,0.5714285714285714,1979-1988
1572,1572,John MacLeod,PHO,9,9,82,46,36,738,395,343,738,395,343,0.535,7.0,2.0,5.0,58.0,27.0,31.0,58.0,27.0,31.0,1981,0.2857142857142857,1979-1988
1573,1573,Jack Ramsay,POR,6,14,82,42,40,492,277,215,1148,609,539,0.53,,,,34.0,19.0,15.0,73.0,33.0,40.0,1981,,1979-1988
1575,1575,Paul Silas,LAC,2,2,82,17,65,164,53,111,164,53,111,0.32299999999999995,,,,,,,,,,1981,,1979-1988
1576,1576,Lenny Wilkens,OKC,8,10,82,52,30,634,357,277,798,432,366,0.541,8.0,3.0,5.0,62.0,35.0,27.0,62.0,35.0,27.0,1981,0.375,1979-1988
1577,1577,Tom Nissalke,UTA,3,11,20,8,12,184,60,124,715,320,395,0.448,,,,,,,31.0,11.0,20.0,1981,,1979-1988
1578,1578,Frank Layden,UTA,1,1,62,17,45,62,17,45,62,17,45,0.274,,,,,,,,,,1981,,1979-1988
1579,1579,Gene Shue,WAS,9,16,82,43,39,712,373,339,1210,608,602,0.502,7.0,3.0,4.0,47.0,17.0,30.0,69.0,28.0,41.0,1981,0.42857142857142855,1979-1988
1580,1580,Lenny Wilkens,ATL,3,23,82,46,36,246,145,101,1864,1014,850,0.544,10.0,4.0,6.0,24.0,9.0,15.0,134.0,64.0,70.0,1995,0.4,1988-1998
1583,1583,Phil Jackson,CHI,7,7,82,72,10,574,414,160,574,414,160,0.721,18.0,15.0,3.0,112.0,81.0,31.0,112.0,81.0,31.0,1995,0.8333333333333334,1988-1998
1584,1584,Mike Fratello,CLE,3,11,82,47,35,246,137,109,823,461,362,0.56,3.0,0.0,3.0,10.0,1.0,9.0,50.0,19.0,31.0,1995,0.0,1988-1998
1585,1585,Dick Motta,DAL,9,24,82,26,56,738,329,409,1883,918,965,0.488,,,,28.0,11.0,17.0,126.0,56.0,70.0,1995,,1988-1998
1586,1586,Bernie Bickerstaff,DEN,2,7,82,35,47,114,55,59,524,257,267,0.49,,,,3.0,0.0,3.0,30.0,12.0,18.0,1995,,1988-1998
1587,1587,Doug Collins,DET,1,4,82,46,36,82,46,36,328,183,145,0.5579999999999999,3.0,0.0,3.0,3.0,0.0,3.0,33.0,13.0,20.0,1995,0.0,1988-1998
1588,1588,Rick Adelman,GSW,1,7,82,36,46,82,36,46,527,327,200,0.62,,,,,,,69.0,36.0,33.0,1995,,1988-1998
1589,1589,Rudy Tomjanovich,HOU,5,5,82,48,34,358,224,134,358,224,134,0.626,8.0,3.0,5.0,65.0,39.0,26.0,65.0,39.0,26.0,1995,0.375,1988-1998
1590,1590,Larry Brown,IND,3,17,82,52,30,246,151,95,1358,814,544,0.599,5.0,2.0,3.0,38.0,22.0,16.0,125.0,61.0,64.0,1995,0.4,1988-1998
1591,1591,Bill Fitch,LAC,2,23,82,29,53,164,46,118,1886,891,995,0.472,,,,,,,106.0,55.0,51.0,1995,,1988-1998
1592,1592,Del Harris,LAL,2,11,82,53,29,164,101,63,837,433,404,0.517,4.0,1.0,3.0,14.0,6.0,8.0,66.0,27.0,39.0,1995,0.25,1988-1998
1593,1593,Pat Riley,MIA,1,14,82,42,40,82,42,40,1137,798,339,0.7020000000000001,3.0,0.0,3.0,3.0,0.0,3.0,215.0,137.0,78.0,1995,0.0,1988-1998
1594,1594,Mike Dunleavy,MIL,4,6,82,25,57,328,107,221,492,208,284,0.423,,,,,,,23.0,13.0,10.0,1995,,1988-1998
1596,1596,Flip Saunders,MIN,1,1,62,20,42,62,20,42,62,20,42,0.32299999999999995,,,,,,,,,,1995,,1988-1998
1598,1598,Don Nelson,NYK,1,19,59,34,25,59,34,25,1480,851,629,0.575,,,,,,,112.0,51.0,61.0,1995,,1988-1998
1599,1599,Jeff Van Gundy,NYK,1,1,23,13,10,23,13,10,23,13,10,0.565,8.0,4.0,4.0,8.0,4.0,4.0,8.0,4.0,4.0,1995,0.5,1988-1998
1600,1600,Brian Hill,ORL,3,3,82,60,22,246,167,79,246,167,79,0.679,12.0,7.0,5.0,36.0,18.0,18.0,36.0,18.0,18.0,1995,0.5833333333333334,1988-1998
1602,1602,Paul Westphal,PHO,4,4,33,14,19,279,191,88,279,191,88,0.685,,,,44.0,25.0,19.0,44.0,25.0,19.0,1995,,1988-1998
1603,1603,Cotton Fitzsimmons,PHO,7,20,49,27,22,541,341,200,1599,832,767,0.52,4.0,1.0,3.0,44.0,22.0,22.0,84.0,35.0,49.0,1995,0.25,1988-1998
1604,1604,P.J. Carlesimo,POR,2,2,82,44,38,164,88,76,164,88,76,0.537,5.0,2.0,3.0,8.0,2.0,6.0,8.0,2.0,6.0,1995,0.4,1988-1998
1606,1606,Bob Hill,SAS,2,6,82,59,23,164,121,43,451,254,197,0.563,10.0,5.0,5.0,25.0,14.0,11.0,37.0,17.0,20.0,1995,0.5,1988-1998
1607,1607,George Karl,OKC,5,9,82,64,18,370,266,104,665,385,280,0.579,21.0,13.0,8.0,58.0,30.0,28.0,72.0,35.0,37.0,1995,0.6190476190476191,1988-1998
1609,1609,Jerry Sloan,UTA,8,11,82,55,27,639,419,220,854,513,341,0.601,18.0,10.0,8.0,77.0,37.0,40.0,83.0,39.0,44.0,1995,0.5555555555555556,1988-1998
1611,1611,Jim Lynam,WAS,2,9,82,39,43,164,60,104,674,306,368,0.454,,,,,,,21.0,8.0,13.0,1995,,1988-1998
1613,1613,Red Auerbach,BOS,4,8,72,42,30,278,166,112,503,309,194,0.614,6.0,2.0,4.0,17.0,6.0,11.0,37.0,15.0,22.0,1953,0.3333333333333333,1950-59
1616,1616,Red Holzman,ATL,1,1,26,10,16,26,10,16,26,10,16,0.385,,,,,,,,,,1953,,1950-59
1617,1617,John Kundla,LAL,6,6,72,46,26,404,273,131,404,273,131,0.6759999999999999,13.0,9.0,4.0,67.0,48.0,19.0,67.0,48.0,19.0,1953,0.6923076923076923,1950-59
1621,1621,Al Cervi,PHI,5,5,72,42,30,339,212,127,339,212,127,0.625,13.0,9.0,4.0,40.0,22.0,18.0,40.0,22.0,18.0,1953,0.6923076923076923,1950-59
1622,1622,Red Auerbach,BOS,5,9,72,36,36,350,202,148,575,345,230,0.6,7.0,3.0,4.0,24.0,9.0,15.0,44.0,18.0,26.0,1954,0.42857142857142855,1950-59
1624,1624,Red Holzman,ATL,2,2,72,26,46,98,36,62,98,36,62,0.3670000000000001,,,,,,,,,,1954,,1950-59
1625,1625,John Kundla,LAL,7,7,72,40,32,476,313,163,476,313,163,0.6579999999999999,7.0,3.0,4.0,74.0,51.0,23.0,74.0,51.0,23.0,1954,0.42857142857142855,1950-59
1629,1629,Al Cervi,PHI,6,6,72,43,29,411,255,156,411,255,156,0.62,11.0,7.0,4.0,51.0,29.0,22.0,51.0,29.0,22.0,1954,0.6363636363636364,1950-59
1631,1631,Jim O'Brien,BOS,2,2,82,49,33,130,73,57,130,73,57,0.562,16.0,9.0,7.0,16.0,9.0,7.0,16.0,9.0,7.0,2001,0.5625,1998-2008
1632,1632,Paul Silas,NOP,4,7,82,44,38,281,161,120,527,239,288,0.454,9.0,4.0,5.0,23.0,11.0,12.0,23.0,11.0,12.0,2001,0.4444444444444444,1998-2008
1637,1637,Don Nelson,DAL,5,24,82,57,25,362,185,177,1842,1036,806,0.562,8.0,4.0,4.0,18.0,8.0,10.0,130.0,59.0,71.0,2001,0.5,1998-2008
1640,1640,Rick Carlisle,DET,1,1,82,50,32,82,50,32,82,50,32,0.61,10.0,4.0,6.0,10.0,4.0,6.0,10.0,4.0,6.0,2001,0.4,1998-2008
1643,1643,Rudy Tomjanovich,HOU,11,11,82,28,54,818,460,358,818,460,358,0.562,,,,90.0,51.0,39.0,90.0,51.0,39.0,2001,,1998-2008
1645,1645,Alvin Gentry,LAC,2,6,82,39,43,164,70,94,345,158,187,0.458,,,,,,,5.0,2.0,3.0,2001,,1998-2008
1646,1646,Phil Jackson,LAL,3,12,82,58,24,246,181,65,984,726,258,0.738,19.0,15.0,4.0,58.0,45.0,13.0,210.0,156.0,54.0,2001,0.7894736842105263,1998-2008
1648,1648,Pat Riley,MIA,7,20,82,36,46,542,329,213,1597,1085,512,0.679,,,,43.0,18.0,25.0,255.0,155.0,100.0,2001,,1998-2008
1649,1649,George Karl,MIL,4,15,82,41,41,296,163,133,1125,666,459,0.5920000000000001,,,,26.0,12.0,14.0,120.0,57.0,63.0,2001,,1998-2008
1650,1650,Flip Saunders,MIN,7,7,82,50,32,522,277,245,522,277,245,0.531,3.0,0.0,3.0,23.0,5.0,18.0,23.0,5.0,18.0,2001,0.0,1998-2008
1651,1651,Byron Scott,BRK,2,2,82,52,30,164,78,86,164,78,86,0.476,20.0,11.0,9.0,20.0,11.0,9.0,20.0,11.0,9.0,2001,0.55,1998-2008
1652,1652,Jeff Van Gundy,NYK,7,7,19,10,9,420,248,172,420,248,172,0.59,,,,69.0,37.0,32.0,69.0,37.0,32.0,2001,,1998-2008
1653,1653,Don Chaney,NYK,1,10,63,20,43,63,20,43,710,285,425,0.401,,,,,,,11.0,2.0,9.0,2001,,1998-2008
1654,1654,Doc Rivers,ORL,3,3,82,44,38,246,128,118,246,128,118,0.52,4.0,1.0,3.0,8.0,2.0,6.0,8.0,2.0,6.0,2001,0.25,1998-2008
1655,1655,Larry Brown,PHI,5,23,82,43,39,378,207,171,1818,1060,758,0.583,5.0,2.0,3.0,46.0,22.0,24.0,171.0,83.0,88.0,2001,0.4,1998-2008
1656,1656,Scott Skiles,PHO,3,3,51,25,26,195,116,79,195,116,79,0.595,,,,13.0,5.0,8.0,13.0,5.0,8.0,2001,,1998-2008
1658,1658,Maurice Cheeks,POR,1,1,82,49,33,82,49,33,82,49,33,0.598,3.0,0.0,3.0,3.0,0.0,3.0,3.0,0.0,3.0,2001,0.0,1998-2008
1659,1659,Rick Adelman,SAC,4,12,82,61,21,296,187,109,905,544,361,0.601,16.0,10.0,6.0,34.0,17.0,17.0,103.0,53.0,50.0,2001,0.625,1998-2008
1660,1660,Gregg Popovich,SAS,6,6,82,58,24,442,279,163,442,279,163,0.631,10.0,4.0,6.0,53.0,31.0,22.0,53.0,31.0,22.0,2001,0.4,1998-2008
1661,1661,Nate McMillan,OKC,2,2,82,45,37,149,83,66,149,83,66,0.557,5.0,2.0,3.0,5.0,2.0,3.0,5.0,2.0,3.0,2001,0.4,1998-2008
1662,1662,Lenny Wilkens,TOR,2,29,82,42,40,164,89,75,2324,1268,1056,0.546,5.0,2.0,3.0,17.0,8.0,9.0,174.0,80.0,94.0,2001,0.4,1998-2008
1663,1663,Jerry Sloan,UTA,14,17,82,44,38,1099,734,365,1314,828,486,0.63,4.0,1.0,3.0,147.0,75.0,72.0,153.0,77.0,76.0,2001,0.25,1998-2008
1664,1664,Doug Collins,WAS,1,7,82,37,45,82,37,45,537,295,242,0.5489999999999999,,,,,,,38.0,15.0,23.0,2001,,1998-2008
1665,1665,Mike Fratello,ATL,4,4,82,50,32,249,124,125,249,124,125,0.498,9.0,4.0,5.0,14.0,6.0,8.0,14.0,6.0,8.0,1985,0.4444444444444444,1979-1988
1666,1666,K.C. Jones,BOS,3,7,82,67,15,246,192,54,576,377,199,0.655,18.0,15.0,3.0,62.0,43.0,19.0,97.0,57.0,40.0,1985,0.8333333333333334,1979-1988
1668,1668,George Karl,CLE,2,2,67,25,42,149,61,88,149,61,88,0.409,,,,4.0,1.0,3.0,4.0,1.0,3.0,1985,,1979-1988
1670,1670,Dick Motta,DAL,6,18,82,44,38,492,212,280,1476,753,723,0.51,10.0,5.0,5.0,24.0,10.0,14.0,122.0,55.0,67.0,1985,0.5,1979-1988
1671,1671,Doug Moe,DEN,6,10,82,47,35,461,254,207,773,431,342,0.5579999999999999,10.0,5.0,5.0,41.0,19.0,22.0,63.0,28.0,35.0,1985,0.5,1979-1988
1672,1672,Chuck Daly,DET,3,4,82,46,36,246,141,105,287,150,137,0.523,4.0,1.0,3.0,18.0,8.0,10.0,18.0,8.0,10.0,1985,0.25,1979-1988
1674,1674,Bill Fitch,HOU,3,16,82,51,31,246,128,118,1312,674,638,0.514,20.0,13.0,7.0,25.0,15.0,10.0,88.0,48.0,40.0,1985,0.65,1979-1988
1676,1676,Don Chaney,LAC,2,2,82,32,50,103,41,62,103,41,62,0.398,,,,,,,,,,1985,,1979-1988
1677,1677,Pat Riley,LAL,5,5,82,62,20,399,286,113,399,286,113,0.7170000000000001,14.0,8.0,6.0,83.0,57.0,26.0,83.0,57.0,26.0,1985,0.5714285714285714,1979-1988
1678,1678,Don Nelson,MIL,10,10,82,57,25,802,490,312,802,490,312,0.611,14.0,7.0,7.0,76.0,36.0,40.0,76.0,36.0,40.0,1985,0.5,1979-1988
1680,1680,Hubie Brown,NYK,4,11,82,23,59,328,138,190,903,441,462,0.488,,,,18.0,8.0,10.0,59.0,31.0,28.0,1985,,1979-1988
1682,1682,John MacLeod,PHO,13,13,82,32,50,1066,557,509,1066,557,509,0.523,,,,81.0,37.0,44.0,81.0,37.0,44.0,1985,,1979-1988
1683,1683,Jack Ramsay,POR,10,18,82,40,42,820,453,367,1476,785,691,0.532,4.0,1.0,3.0,59.0,29.0,30.0,98.0,43.0,55.0,1985,0.25,1979-1988
1684,1684,Phil Johnson,SAC,7,8,82,37,45,496,222,274,497,222,275,0.447,3.0,0.0,3.0,9.0,2.0,7.0,9.0,2.0,7.0,1985,0.0,1979-1988
1685,1685,Cotton Fitzsimmons,SAS,2,15,82,35,47,164,76,88,1222,588,634,0.481,3.0,0.0,3.0,8.0,2.0,6.0,40.0,13.0,27.0,1985,0.0,1979-1988
1686,1686,Bernie Bickerstaff,OKC,1,1,82,31,51,82,31,51,82,31,51,0.378,,,,,,,,,,1985,,1979-1988
1687,1687,Frank Layden,UTA,5,5,82,42,40,390,175,215,390,175,215,0.449,4.0,1.0,3.0,25.0,10.0,15.0,25.0,10.0,15.0,1985,0.25,1979-1988
1688,1688,Gene Shue,WAS,13,20,69,32,37,1027,522,505,1525,757,768,0.496,,,,55.0,19.0,36.0,77.0,30.0,47.0,1985,,1979-1988
1689,1689,Kevin Loughery,WAS,1,14,13,7,6,13,7,6,987,459,528,0.465,5.0,2.0,3.0,5.0,2.0,3.0,48.0,25.0,23.0,1985,0.4,1979-1988
